[name_184_184]
ConfigVer=20210427_0
[name_184_185]
ConfigVer=20210427_3656951050
AABA-1=Aabaco Holdings
AACG=Ata Creativity
AAL=美国航空
AAME=美国大西洋
AAOI=应用光电
AAON=艾伦建材
AAPL=苹果
AAWW=阿特拉斯环球航空
AAXJ=亚洲非日国家指数ETF
ABCB=ABC银行
ABCL=AbCellera Biologics
ABCM=Abcam
ABMD=阿比奥梅德
ABNB=爱彼迎
ABST=Absolute Software
ABTX=Allegiance
ABUS=Arbutus生物制药
ACAD=阿卡迪亚
ACAP=American Capital
ACBI=Atlantic Capital
ACCD=Accolade
ACET=Adicet Bio
ACGL=艾奇资本
ACGLO=艾奇资本优先
ACGLP=艾奇资本优先
ACHC=阿卡迪亚医疗保健
ACHL=Achilles
ACIU=AC Immune
ACIW=ACI环球
ACLS=亚舍立科技
ACMR=盛美半导体
ACOR=阿索尔达治疗
ACRS=Aclaris Therapeutics
ACRX=AcelRx制药
ACTG=阿卡西亚
ACWI=MSCI ACWI指数ETF
ACWX=ACWI除美国外指数ETF
ADAG=天演药业
ADAP=Adaptimmune治疗
ADBE=奥多比
ADES=Advanced Emissions
ADI=亚德诺
ADMS=Adamas
ADP=自动数据处理
ADPT=Adaptive生物技术
ADRE=新兴市场50ADR指数ETF
ADSK=欧特克
ADTN=亚川
ADUS=爱德斯
ADVM=Adverum生物科技
AEGN=Aegion
AEIS=先进能源工业
AEP=美国电力
AERI=Aerie医药
AEY=先进科技
AFCG=AFC Gamma
AFIB=Acutus Medical
AFIN=American金融信托
AFINP=American信托优先A
AFMD=Affimed
AFRM=Affirm Holdings
AFYA=Afya
AGFS=AgroFresh Solutions
AGIO=Agios制药
AGLE=Aeglea生物制药
AGNC=AGNC Investment
AGNCM=AGNC优先 D
AGNCN=AGNC优先 C
AGNCO=AGNC优先 E
AGNCP=AGNC优先 F
AGNG=Global X人口老龄化
AGTC=Applied Genetic
AGYS=诶吉利斯
AGZD=美国综合债券负期基金
AIA=亚洲50指数ETF
AIH=医美国际
AIMC=奥创控股
AINV=阿波罗投资
AIQ=人工智能和大数据指数
AIRR=美国工业复兴指数ETF
AKAM=阿克迈技术
AKBA=Akebia Therapeutics
AKRO=Akero Therapeutics
AKUS=Akouos
AKYA=Akoya Biosciences
ALCO=阿里科
ALEC=Alector
ALGM=Allegro
ALGN=阿莱技术
ALGS=Aligos
ALGT=忠实航空
ALHC=Alignment Healthcare
ALIM=Alimera医疗科学
ALIT=Alight
ALJJ=ALJ Regional
ALKS=阿尔凯默斯
ALKT=Alkami Technology
ALLK=Allakos
ALLO=Allogene疗法
ALLT=艾奥特
ALNA=Allena制药
ALNY=阿尔尼拉姆制药
ALOT=AstroNova
ALPN=Alpine Immune
ALRM=Alarm.com控股
ALRN=Aileron Therapeutics
ALSK=阿拉斯加通信系统
ALT=Altimmune
ALTR=Altair Engineering
ALTY=超级股息替代指数ETF
ALVR=Allovir
ALXN=亚力兄制药
ALXO=ALX Oncology
ALZH=Alzheon
AMAL=Amalgamated
AMAT=应用材料
AMBA=安霸
AMCA=纯国内曝光指数ETF
AMCX=AMC网络
AMED=阿米斯医疗
AMGN=安进
AMKR=艾马克技术
AMNB=美国国家银行
AMOT=Allied Motion科技
AMPH=Amphastar
AMRB=里弗银行
AMRK=A-mark Precious
AMRN=阿玛琳
AMRS=阿米瑞斯
AMSC=美国超导
AMSF=Amerisafe
AMSWA=美国软件
AMTB=Amerant银行A
AMTBB=Amerant银行B
AMTI=Applied Molecular
AMTX=Aemetis
AMWD=伍德马克
AMYT=Amryt Pharma
AMZN=亚马逊
ANAB=AnaptysBio
ANAT=National Group
ANDE=安德森斯
ANGI=Angi
ANGN=Angion Biomedica
ANGO=盎格鲁力学
ANIK=阿尼卡医疗
ANIP=阿尼制药
ANNX=Annexon
ANPC=安派科生物医学科技
ANSS=安西斯
ANTE=航美科技
ANTE-1=Anterios
AOSL=阿尔法和欧米伽半导体
AOUT=American Outdoor
APA=阿帕奇
APEI=美国公共教育
APEN=Apollo Endosurgery
APHA=Aphria
API=声网
APLS=Apellis制药
APLT=Applied疗法
APM=知临集团
APOG=爱宝奇
APP=Applovin
APPF=Appfolio
APPN=Appian
APR=Apria
APRE=Aprea Therapeutics
APTX=Aptinyx
APVO=Aptevo Therapeutics
APWC=亚太电线电缆
APYX=Apyx Medical
AQST=Aquestive疗法
AQWA=Global X净水ETF
ARAV=Aravive
ARAY=精确射线
ARCB=ArcBest
ARCC=阿瑞斯资本
ARCE=Arco Platform
ARCM-1=American Realty
ARCT=Arcturus医疗
ARDX=Ardelyx
ARGX=argenx
ARKR=方舟餐厅
ARLP=阿莱恩斯资源
ARNA=阿里那制药
AROG=Arog Pharmaceuticals
AROW=箭牌金融
ARQT=Arcutis
ARRY=Array Technologies
ARTNA=自流资源
ARVL=Arrival Group
ARVN=Arvinas
ARWR=箭头制药
ASCMA=Monitronics国际
ASET=不动产分配指数ETF
ASLN=亚狮康药业
ASML=阿斯麦
ASND=Ascendis制药
ASO=Academy
ASPS=Altisource Portfolio
ASRT=Assertio Holdings
ASRV=美斯夫银行
ASTE=雅达电子工业
ASYS=阿姆科技
ATAI=ATAI Life Sciences
ATAX=美国第一多户家庭投资
ATEC=阿尔法泰克控股
ATHA=Athira
ATLC=Atlanticus Holdings
ATNI=大西洋电讯
ATNX=Athenex
ATRA=Atara生物治疗
ATRC=AtriCure
ATRI=Atrion
ATRO=太空电子
ATSG=航空运输服务
ATVI=动视暴雪
AUB=Atlantic Union
AUBN=奥本银行
AUDC=奥科
AUPH=Aurinia制药
AUTL=Autolus Therapeutics
AVAH=Aveanna Healthcare
AVAV=航空环境
AVDL=Avadel制药
AVGO=博通
AVID=艾维科技
AVIR=Atea
AVNW=阿维亚网络
AVO=Mission Produce
AVRO=AVROBIO
AVT=安富利
AWRE=艾卫
AXLA=Axcella Health
AXNX=Axonics
AXON=Axon Enterprise
AXSM=Axsome Therapeutics
AXTI=AXT
AY=亚特兰大持续基础设施
AYLA=Ayala制药
AZN=阿斯利康
AZPN=艾斯本科技
AZYO=Aziyo Biologics
BAND=Bandwidth
BANF=BancFirst银行
BANR=邦纳
BANX=Stonecastle金融
BATRA=Liberty Braves A
BATRK=Liberty Braves C
BBBY=3B家居
BBGI=比斯利广播
BBH=MVIS美国上市生物技术
BBIO=BridgeBio Pharma
BBQ=BBQ Holdings
BBSI=巴雷特商业服务
BCAB=Bioatla
BCBP=BCB银行
BCEL=Atreca
BCML=BayCom
BCOR=Blucora
BCOV=布莱克维
BCPC=拜切
BCRX=Biocryst医药
BCYC=Bicycle治疗
BDSX=Biodesix
BDTX=Black Diamond
BEAM=Beam Therapeutics
BECN=比肯鲁夫
BELFA=贝尔保险丝A
BELFB=贝尔保险丝B
BFIN=班克金融
BFIT=Indxx全球健康与养生
BFST=Business First
BGCP=BGC Partners
BGFV=Big 5体育用品
BGNE=百济神州
BGRN=全球绿色选择债券ETF
BHF=Brighthouse
BHFAP=Brighthouse优先A
BIB=生物技术指数两倍做多
BICK=信息安全工程BICK指数
BIDU=百度
BIGC=Bigcommerce Holdings
BIIB=生化基因
BILI=哔哩哔哩
BIS=生物技术指数两倍做空
BJRI=Bjs餐饮
BKCC=黑岩凯尔索资本
BKEP=Blueknight
BKEPP=Blueknight优先
BKNG=Booking Holdings
BL=BlackLine
BLBD=Blue Bird
BLCM=Bellicum制药
BLCN=区块链经济指数ETF
BLCT=蓝城兄弟
BLDP=巴拉德动力系统
BLDR=Builders Firstsource
BLFY=Blue Foundry
BLI=Berkeley Lights
BLKB=布莱克波特科技
BLMN=Bloomin'Brands
BLPH=柏勒罗丰治疗
BLU=BELLUS Health
BLUE=bluebird bio
BMBL=Bumble
BMEA=Biomea Fusion
BMRN=拜玛林制药
BMTC=布林摩尔银行
BNDW=全球总体浮动调整综合
BNDX=全球国际债券ETF
BNFT=集益软件
BNR=燃石医学
BNTX=BioNTech
BOCH=科默斯银行控股
BOKF=BOK银行
BOLT=Bolt Biotherapeutics
BOOM=DMC Global
BOTZ=全球机器人与人工智能
BPFH=波士顿金融控股
BPMC=蓝图医药
BPOP=大众银行
BPRN=Princeton银行
BPY=Brookfield
BPYPO=Brookfield优先2
BPYPP=Brookfield优先1
BPYU=Brookfield Property
BPYUP=Brookfield优先A
BRID=Bridgford Foods
BRKL=布鲁克赖恩银行
BRKR=布鲁克
BRKS=布鲁克斯自动化
BRP=BRP Group
BRY=Berry
BSCT=公司债券2029指数ETF
BSCU=公司债券2030指数ETF
BSET=巴西特家具
BSJR=公司债券2027指数ETF
BSJS=高收益公司债券2028
BSML=市政债券2021指数ETF
BSMM=市政债券2022指数ETF
BSMN=市政债券223指数ETF
BSMO=市政债券224指数ETF
BSMP=市政债券225指数ETF
BSMQ=市政债券226指数ETF
BSMR=市政债券227指数ETF
BSMS=市政债券228指数ETF
BSMT=消费者上限指数ETF
BSMU=市政债券2030指数ETF
BSQR=BSQUARE科技
BSRR=塞拉银行
BSVN=Bank7
BSY=Bentley Systems
BTEC=纳斯达克医疗保健创新
BTRS=BTRS Holdings
BUG=Indxx网络安全指数ETF
BUSE=布西第一银行
BVS=Bioventus
BWAY=Brainsway
BWFG=Bankwell Financial
BWMN=Bowman Consulting
BYND=Beyond Meat
BZUN=宝尊电商
CABA=Cabaletta Bio
CAC=卡姆登国家银行
CACC=Credit Acceptance
CACG=ClearBridge所有成长
CAKE=起司工坊
CALA=Calithera生物科学
CALB=加利福尼亚银行
CALM=卡尔梅尔食品
CALT=Calliditas
CAMP=Calamp
CAMT=康特科技
CAN=嘉楠科技
CAR=安飞士
CARA=Cara Therapeutics
CARE=Carter Bankshares
CARG=CarGurus
CARZ=纳斯达克全球汽车指数
CASA=Casa Systems
CASH=米塔金融
CASS=卡斯信息系统
CASY=凯西通用零售
CATB=缓解制药
CATH=标普500天主教价值ETF
CATM=Cardtronics
CATY=国泰万通金控
CBAN=科勒尼
CBAT=CBAK能源科技
CBFV=CB金融服务
CBNK=Capital Bancorp
CBPO=泰邦生物
CBRL=CB乡村店
CBSH=科默斯银行
CBTX=CBTX
CCAP=Crescent Capital
CCB=Coastal Financial
CCBG=都市银行集团
CCCC=C4 Therapeutics
CCLP=CSI Compressco
CCMP=CMC Materials
CCNE=CNB金融
CCOI=Cogent通讯
CCRN=越野保健
CCXI=ChemoCentryx
CD=秦淮数据
CDAK=Codiak BioSciences
CDC=高息100长/现货波动
CDK=CDK Global
CDL=大盘股高息100加权
CDLX=Cardlytics
CDNA=CareDx
CDNS=铿腾电子
CDTX=Cidara Therapeutics
CDW=CDW
CDXS=Codexis
CDZI=加的斯
CECE=CECO环保
CEFA=开发非美天主教价值
CENT=中央花园和宠物
CENTA=中央花园和宠物A
CENX=世纪铝业
CERN=塞纳
CERS=Cerus
CERT=Certara
CEVA=Ceva
CEY=高股息100波动加权
CFA=美国大盘500波动加权
CFB=CrossFirst银行股
CFFI=C&F金融
CFFN=国会大厦联储
CFMS=Conformis
CFO=大盘500长/现货波动
CG=凯雷集团
CGBD=Tcg Bdc
CGC=Canopy Growth
CGEM=Cullinan Oncology
CGEN=Compugen医疗
CGNT=Cognyte Software
CGNX=康耐视科技
CHB=中国生物技术创新ETF
CHCO=城市控股
CHDN=邱吉尔园
CHEF=厨师的仓库
CHI=Calamos转换收入基金
CHIC=中国通信服务指数ETF
CHK=切萨皮克能源
CHKP=Check Point软件
CHMA=Chiasma
CHMG=Chemung Financial
CHNA=中国生物制药指数ETF
CHNG=Change Healthcare
CHRS=Coherus生物科技
CHRW=罗宾逊全球物流
CHSCL=CHS优先B4
CHSCM=CHS优先B3
CHSCN=CHS优先B2
CHSCO=CHS优先B1
CHSCP=CHS优先
CHTR=Charter通信
CHUY=Chuy's Holdings
CHX=ChampionX
CHY=Calamos CHI Fund
CIBR=纳斯达克网络安全ETF
CID=高股息100波动加权
CIDM=Cinedigm
CIGI=高力国际集团
CIH=中指控股
CIL=国际500波动加权指数
CINF=辛辛那提金融
CIZ=500长/现货波动加权
CIZN=市民金融控股
CLAR=Clarus
CLBK=哥伦比亚金融
CLDX=塞德斯医疗
CLFD=克利尔菲尔德
CLLS=Cellectis
CLMT=卡路美
CLNE=清洁能源
CLOU=Indxx全球云计算指数
CLOV=Clover Health
CLRG=蔡金电力美国大盘指数
CLSD=Clearside生物医学
CLVS=Clovis肿瘤药物
CLXT=Calyxt
CMBM=Cambium Networks
CMCO=哥伦布-麦金农
CMCSA=康卡斯特A
CMCT=CIM商业信托
CMCTP=CIM商业信托优先L
CME=芝加哥商品交易所
CMLS=积云媒体
CMPI=Checkmate
CMPR=Cimpress
CMPS=COMPASS Pathways
CMRX=Chimerix
CMTL=康姆泰克通讯
CNBKA=世纪银行
CNCE=Concert
CNCR=癌症免疫治疗指数ETF
CNDT=Conduent
CNFR=康年控股
CNOB=ConnectOne
CNSL=联合通讯
CNST=Constellation制药
CNTA=Centessa
CNTB=康乃德生物
CNTG=Centogene
CNTX=Centrexion疗法
CNXC=Concentrix
CNXN=PC联络商务
COGT=Cogent Biosciences
COHR=Coherent
COHU=科休半导体
COIN=Coinbase Global
COKE=可口可乐合并
COLB=哥伦比亚银行系统
COLL=Collegium制药
COLM=哥伦比亚户外
COMM=康普
COMT=商品选择策略ETF
CONE=Cyrusone
CONN=科恩
CORE=科尔.马克控股
COST=好市多
COUP=Coupa Software
COWN=Cowen
CPHC=坎特伯雷帕克控股
CPIX=坎伯兰药业
CPLP=Capital Product
CPOP=普普文化
CPRT=科帕特
CPSI=计算机程序和系统
CPSS=消费信贷组合服务
CPTA=Capitala金融
CPZ=Calamos L/SE&DIT信托
CRAI=CRA国际
CRBO=Carbon Natural Gas
CRBP=Corbus制药控股
CRCT=Cricut
CREE=克里科技
CRESY=Cresud
CRIS=居里
CRMD=CorMedix
CRMT=美国汽车行
CRNC=Cerence
CRNT=Ceragon网络
CRNX=Crinetics制药
CRON=Cronos Group
CROX=卡骆驰
CRSP=CRISPR Therapeutics
CRSR=Corsair Gaming
CRSR-1=Corsair电脑元件
CRTO=Criteo
CRTX=Cortexyme
CRUS=凌云半导体
CRVL=CorVel
CRVS=Corvus制药
CRWD=CrowdStrike Holdings
CSA=美小盘股500波动加权
CSB=美小盘股高息100波动
CSCO=思科
CSF=美小盘股500长期/现金
CSGP=科斯塔
CSGS=CSG系统国际
CSII=泰尔茂心血管系统
CSIQ=阿特斯太阳能
CSML=美国小盘股指数ETF
CSOD=Cornerstone Ondemand
CSPI=CSP
CSSE=心灵鸡汤娱乐
CSSEP=心灵鸡汤娱乐优先A
CSTE=Caesarstone
CSTL=Castle Biosciences
CSTR=CapStar金融控股
CSTX=Cirius Therapeutics
CSWC=西南资本
CSWI=Csw
CSX=CSX运输
CTAS=信达思
CTBI=大众信托合众银行
CTEC=Global X清洁技术ETF
CTG=计算机作业集团
CTLP=Cantaloupe
CTMX=CytomX医疗
CTRE=房地产投资信托基金
CTRN=Citi Trends
CTSH=高知特
CTXS=思杰系统
CUTR=古特拉
CVAC=Curevac
CVBF=CVB金融
CVCO=卡寇工业
CVET=Covetrus
CVGI=商用汽车
CVGW=卡拉沃养殖
CVLG=Covenant Logistics
CVLT=康沃系统
CVLY=科多勒斯谷万通金控
CWBC=西部社区银行
CWCO=统一水务
CWST=卡塞拉废物系统
CXDC=鑫达集团
CXSE=中国企业指数ETF
CYAD=Celyad Oncology
CYBE=数码光学科技
CYBR=CyberArk Software
CYCN=Cyclerion医疗
CYTK=细胞动力科技
CZR=Caesars
CZWI=市民大众
DADA=达达
DAKT=Daktronics
DALI=多尔西莱特DALI 1指数
DAPP=VanEck矢量数字转化
DAX=法兰克福指数ETF
DBTX=Decibel Therapeutics
DBVT=DBV Technologies
DBX=Dropbox
DCBO=Docebo
DCOM=Dime Community
DCPH=Deciphera医药
DCT=Duck Creek
DDI=DoubleDown
DDIV=动量加股息收益指数
DDOG=Datadog
DECI=Decipher Biosciences
DEMZ=民主大盘股核心ETF
DFH=Dream Finders Homes
DFVL=美国国债期货目标暴露
DFVS=5Y国债期货暴露做空
DGICA=多尼戈尔股份A
DGICB=多尼戈尔股份B
DGII=美国迪进国际
DGRE=新兴市场质量红利增长
DGRS=美国小盘优质红利增长
DGRW=美国优质股息增长
DHC=Diversified
DHIL=钻石山投资集团
DIOD=Diodes
DISCA=探索传播A
DISCB=探索传播B
DISCK=探索传播C
DISH=视频网络
DKNG=DraftKings
DLTH=德卢斯控股
DLTR=美元树
DMLP=多尔切斯特
DMRC=数字标识
DMXF=选择ESG筛选指数ETF
DNLI=Denali治疗
DOCU=DocuSign
DOGZ=多尼斯
DOLE=都乐食品
DOMO=Domo
DOOO=BRP
DORM=Dorman
DOX=Amdocs
DOYU=斗鱼
DRIV=自发和电动汽车指数
DRMT=Dermavant Sciences
DRNA=Dicerna制药
DRRX=Durect
DRTT=DIRTT Environmental
DRVN=Driven Brands
DSEY=Diversey Holdings
DSGN=Design Therapeutics
DSGX=笛卡尔物流系统集团
DSP=Viant Technology
DSPG=DSP集团
DSWL=德斯维尔工业
DTEA=DAVIDsTEA
DTIL=Precision生物科学
DUO=房多多
DVLU=多尔西赖特动量加值
DVOL=动量外加低波动率指数
DVY=道琼斯美国精选股息
DWAS=小盘股技术领导者
DWAT=Arrow DWA战术宏ETF
DWAW=FSM全市值ETF
DWCR=多西莱特国家股票动量
DWEQ=Alpha等重ETF
DWMC=多尔西赖特微型股ETF
DWPP=人民投资组合指数ETF
DWSH=赖特短期顾问公司
DWSN=道森地探
DWUS=FSM美国核心ETF
DXCM=德康医疗
DXGE=德国对冲股票指数ETF
DXJS=日本小盘股对冲股票
DXPE=DXP企业
DXYN=迪克希
DYN=Dyne
EA=艺电
EAR=Eargo
EBAY=eBay
EBC=Eastern Bankshares
EBIX=亚太交换中心
EBIZ=电子商务指数ETF
EBMT=Eagle Bancorp
EBON=亿邦国际
EBSB=莫里迪恩洲际合众银行
EBTC=Enterprise Bancorp
ECHO=Echo Global
ECOL=美国生态
ECOR=electroCore
ECOW=摇钱树1指数ETF
ECPG=安可资本
EDAP=EDAP TMS
EDIT=Editas Medicine
EDOC=远程医疗健康指数ETF
EDUC=Educational
EDUT=全球教育主题指数ETF
EEFT=嘉银通
EEMA=新兴市场亚洲定制封顶
EFAS=MSCI EAFE 50强分红
EFSC=企业财务服务
EGLE=伊格尔散货航运
EGOV=Nic
EGRX=Eagle
EH=亿航智能
EHTH=易康
EIGR=Eiger
ELOX=Eloxx制药
EM=怪兽充电
EMB=EMBI全球核心指数ETF
EMCB=新兴市场公司债券基金
EMIF=标普新兴市场基础设施
EMKR=埃姆科
EML=The Eastern
EMXC=新兴市场前中国指数
EMXF=选择筛选5%发行人上限
ENDP=远藤制药
ENPH=Enphase能源
ENSG=恩赛因
ENTA=Enanta制药
ENTG=英特格
ENZL=新西兰指数IMI25/50
EOLS=Evolus
EPAY=底线科技
EPZM=Epizyme
EQ=Equillium
EQBK=Equity Bancshares
EQIX=易昆尼克斯
EQRR=美国大盘股增长率指数
ERIC=爱立信
ERIE=伊瑞保险
ERII=能源回收
ERYP=ERYTECH Pharma
ESCA=攀登者
ESG=STOXX美国ESG影响
ESGD=EAFE扩展ESG焦点指数
ESGE=新兴市场扩展ESG焦点
ESGG=全球ESG影响指数ETF
ESGR=恩斯塔
ESGRO=恩斯塔优先E
ESGRP=恩斯塔优先D
ESGU=美国扩展ESG焦点指数
ESLT=Elbit系统
ESPR=Esperion
ESSA=萨万通金控
ETNB=89bio
ETON=Eton Pharmaceuticals
ETSY=Etsy
ETTX=Entasis医疗控股
EUFN=MSCI欧洲财务指数ETF
EVBG=Everbridge
EVER=EverQuote
EVGN=Evogene
EVK=华瑞
EVLO=Evelo Biosciences
EVOP=EVO Payments
EWBC=华美
EWEB=互联网与电子商务ETF
EWJE=MSCI日本平等加权指数
EWJV=MSCI日本价值指数ETF
EWTX=Edgewise
EWZS=MSCI巴西小盘股指数
EXC=爱克斯龙
EXEL=伊克力西斯
EXFO=EXFO
EXLS=伊克赛尔服务控股
EXPD=康捷国际物流
EXPE=Expedia
EXPI=eXp World控股
EXPO=毅博科技咨询
EXTR=极速网络
EYE=National Vision
EYPT=EyePoint
EZPW=艾茨克普
FAAR=可替代绝对回报策略
FAB=纳斯达克多头价值指数
FAD=纳斯达克多头成长指数
FALN=美高收益封顶指数ETF
FANG=Diamondback能源
FANH=泛华金控
FARM=Farmer Bros
FARO=法如科技
FAST=快扣
FATE=Fate Therapeutics
FB=脸谱网
FBIZ=第一商业金融服务
FBMS=第一银行股份
FBNC=第一万能金控
FBRX=Forte Biosciences
FBZ=AlphaDEX巴西指数ETF
FCA=AlphaDEX中国指数ETF
FCAL=加州市高收入ETF
FCBC=第一社区银行股份
FCCY=第一机构银行
FCEF=CEF收入机会ETF
FCEL=燃料电池能源
FCFS=第一富金融服务
FCNCA=第一公民银行股份
FCRD=First Eagle
FCVT=战略可转换证券ETF-
FDBC=Fidelity D & D
FDIV=战略收入ETF
FDMT=4D Molecular
FDNI=道琼斯国际互联网ETF
FDT=AlphaDEX非美发达市场
FDTS=非美国发达市场小盘股
FDUS=Fidus投资
FEIM=高频电子
FELE=富兰克林电子
FEM=AlphaDEX新兴市场指数
FEMB=新兴市场本地货币债券
FEMS=AlphaDEX新兴市场小盘
FEP=AlphaDEX欧洲指数ETF
FEUZ=欧元区指数ETF
FEX=AlphaDEX大盘核心ETF
FEYE=火眼
FFBC=第一金融银行股份
FFIC=法拉盛金融
FFIN=第一金融银行股份
FFIV=F5网络
FFNW=第一财经西北
FFWM=First Foundation
FGBI=第一抵押银行
FGEN=纤维蛋白原
FGF=FG Financial
FGFPP=1347 Property优先
FGM=AlphaDEX德国指数ETF
FHB=First Hawaiian
FHTX=Foghorn
FIBK=First Bancsystem国际
FICS=国际发达资本实力ETF
FID=标普国际股息贵族指数
FINX=INDXX全球金融主题
FISI=金融机构
FISV=费哲金融服务
FITB=五三银行
FITBI=五三银行优先存托 I
FITBO=五三银行优先存托 K
FITBP=五三银行优先存托 A
FIVE=Five Below
FIVN=Five9
FIXD=第一信托TCW固定收益
FIXX=Homology Medicines
FIZZ=全国饮料
FJP=AlphaDEX日本指数ETF
FKU=AlphaDEX英国指数ETF
FLDM=Fluidigm
FLEX=伟创力国际
FLGT=Fulgent Genetics
FLIR=菲利尔系统
FLN=AlphaDEX拉丁美洲ETF
FLNT=Fluent
FLWS=1-800-FLOWERS.COM
FLXN=Flexion Therapeutics
FLXS=弗莱克斯蒂尔工业
FMB=管理型市场ETF
FMBH=First Mid Bancshares
FMBI=第一中西部银行
FMHI=第一信托城市高收入
FMMP=FM Motorparts
FMTX=Forma Therapeutics
FNCH=Finch Therapeutics
FNHC=FedNat Holding
FNK=AlphaDEX中值指数ETF
FNKO=Funko
FNLC=第一万通金控
FNWB=First Northwest
FNX=AlphaDEX中盘核心ETF
FNY=AlphaDEX中期成长ETF
FOCS=Focus金融伙伴
FOLD=爱美医疗
FORM=FormFactor
FORR=佛罗斯特研究
FORTY=配方系统
FOSL=福斯尔
FOX=Fox B
FOXA=Fox A
FOXF=福克斯工厂控股
FPA=非日本亚太指数ETF
FPXE=IPOX 100欧洲指数
FPXI=IPOX国际指数ETF
FRBA=First Bank
FRBK=共和国第一万通金控
FREQ=Frequency
FRG=Franchise Group
FRGI=嘉年华酒店集团
FRLN=Freeline
FRME=第一招商股份
FROG=Jfrog
FRPH=FRP Holdings
FRPT=Freshpet
FRST=Primis Financial
FRTA=Forterra
FSBC=Five Star Bancorp
FSLR=第一太阳能
FSTM=Fusionstorm环球
FSTR=LB福斯特
FSV=Firstservice
FSZ=AlphaDEX瑞士指数ETF
FTA=大盘价值指数ETF
FTAG=Indxx全球农业指数ETF
FTC=AlphaDEX大盘成长ETF
FTCI=FTC Solar
FTCS=纳斯达克资本实力指数
FTDR=frontdoor
FTEK=燃料技术
FTFT=未来金融科技
FTGC=主动型商品战略ETF
FTHI=第一信托BuyWrite收入
FTLB=对冲BuyWrite收入ETF
FTNT=飞塔信息
FTRI=自然资源收入指数ETF
FTSL=高级贷款基金ETF
FTSM=增强短期到期ETF
FTXD=纳斯达克智能零售指数
FTXG=纳斯达克智能食品饮料
FTXH=纳斯达克美国智能药品
FTXL=美智能半导体指数ETF
FTXN=纳斯达克智能油气指数
FTXO=美国智能银行指数ETF
FTXR=纳斯达克智能交通指数
FUDA=富达集团(美国)
FULC=Fulcrum Therapeutics
FULT=富尔顿金融
FUNC=马里兰第一联合
FUSN=Fusion
FUTU=富途控股
FV=焦点五指数ETF
FVC=赖特动态焦点五指数
FWONA=自由传媒 A
FWONK=自由传媒 C
FWP=Forward Pharma
FWRD=福沃运输
FYC=AlphaDEX小盘成长ETF
FYT=AlphaDEX小盘价值ETF
FYX=AlphaDEX小盘核心ETF
GABC=德美银行
GAIA=Gaia
GAIA-1=Gaia-1
GAIN=格拉德斯通投资
GAINL=格拉德斯通投资优先L
GANX=Gain Therapeutics
GASS=斯蒂加斯海运
GBCI=冰川万通金控
GBDC=Golub Capital BDC
GBIO=Generation Bio
GBLI=Global Indemnity
GBLK=GoodBulk
GBS=GBS
GBT=全球血液疗法
GDEN=黄金娱乐
GDRX=Goodrx
GDS=万国数据
GECC=Great Elm Capital
GEG=Forest Investments
GENC=范科工业
GENY=千年机会指数ETF
GEOS=Geospace技术
GERN=杰龙
GFED=GFED银行
GFN=通用金融
GFNCP=通用金融C类优先
GH=Guardant Health
GIFI=海湾岛制造
GIGE=SoFi Gig经济ETF
GIII=G-III服装集团
GILD=吉利德科学
GILT=吉来特卫星网络
GLAD=格拉德斯通资本
GLBE=Global-E Online
GLDD=大湖船坞
GLDI=黄金流动103指数ETF
GLNG=Golar海运
GLPG=Galapagos
GLPI=Gaming And Leisure
GLRE=绿光资本
GLTO=Galecto
GLUU=Glu移动
GLYC=Glycomimetics
GMAB=Genmab
GMDA=Gamida Cell
GMLPP=Golar Lng优先A
GMTX=Gemini Therapeutics
GMVD=G医疗创新控股
GNCA=Genocea Biosciences
GNFT=Genfit
GNLN=Greenlane控股
GNMA=美国GNMA债券指数ETF
GNMK=GenMark诊断
GNOM=基因组学指数
GNTX=真泰克
GNTY=Guaranty Bancshares
GO=Grocery Outlet
GOCO=GoHealth
GOGL=金海洋集团
GOGO=Gogo
GOOD=格拉德斯通商业
GOODM=格拉德斯通商业优先D
GOODN=格拉德斯通商业优先E
GOOG=谷歌C
GOOGL=谷歌A
GOSS=Gossamer Bio
GPP=Green Plains
GPRE=绿色平原
GPRO=Gopro
GRAL=Grail
GRAY=Graybug
GRCL=亘喜生物
GRFS=GRIFOLS
GRID=纳斯达克清洁智能电网
GRIN=Grindrod Shipping
GRMN=佳明
GRPN=Groupon
GRTS=Gritstone Oncology
GRTX=Galera Therapeutics
GSBC=南方万通金控
GSHD=Goosehead Insurance
GSIT=广船国际技术
GSKY=Greensky
GSM=Ferroglobe
GT=固特异轮胎橡胶
GTH=泛生子
GTHX=G1治疗
GURE=海湾资源
GWPH=吉瓦制药
GWRS=全球水资源
GXTG=主动主题成长指数ETF
HA=夏威夷控股
HAFC=韩美金融
HAIN=海恩时富
HALL=标志金融服务
HALO=奥洛兹美医疗
HARP=Harpoon Therapeutics
HAS=孩之宝
HAYN=海恩斯国际
HBAN=亨廷顿银行
HBANN=亨廷顿银行优先C
HBANO=亨廷顿银行优先存托
HBCP=Home合众银行
HBIO=哈佛生物科学
HBNC=哈里逊合众银行
HBT=HBT Financial
HCAP=汉威资本信贷
HCAT=Health Catalyst
HCCI=传承水晶清洁
HCG=hear.com
HCKT=哈克特服务
HCM=和黄医药
HCSG=医疗保健服务
HEAR=乌龟海岸
HEES=HE设备服务
HELE=海伦特洛伊家电
HERD=摇钱树基金指数ETF
HERO=视频游戏电竞指数ETF
HEWG=德国100%对冲美元ETF
HFWA=Heritage金融银行
HHR=HeadHunter Group
HIBB=希贝特体育
HIFS=欣厄姆银行
HIMX=奇景光电
HLAL=Shariah美国指数ETF
HLG=海亮教育
HLIO=Helios Technologies
HLIT=谐波
HLNE=Hamilton Lane
HMHC=霍顿米夫林夏
HMNF=HMN金融
HMPT=Home Point Capital
HMST=Homestreet
HMTV=半球传媒集团
HNDL=纳斯达克7交易指数ETF
HNST=The Honest
HOFT=胡克家具
HOLI=和利时自动化
HOLX=豪洛捷
HOMB=首页银行投资
HONE=Harborone Bancorp
HOOK=HOOKIPA制药
HOPE=Hope Bancorp
HOVNP=霍夫纳尼安存托优先
HOWL=Werewolf
HPK=HighPeak Energy
HQY=Healthequity
HRMY=Harmony
HRZN=Horizon科技金融
HSIC=亨利香恩服务
HSII=海德思哲服务
HSON=哈德森全球
HST=豪斯特酒店
HSTM=健康流科技
HTBI=Hometrust Bancshares
HTBK=文物商业
HTHT=华住
HTLD=哈特兰快递
HTLF=哈特兰金融
HUBG=枢纽
HUIZ=慧择
HURC=赫克
HURN=休伦咨询
HWBK=Hawthorn Bancshares
HWC=汉考克惠特尼
HWCC=休斯顿电线电缆
HWKN=霍金斯材料
HX=小白买买
HYFM=Hydrofarm
HYGO=Hygo Energy
HYLS=战术高收益ETF
HYW=海银财富
HYXF=高收益选择ESG筛选ETF
HYZD=美高收益公司债券ETF
HZNP=Horizon Therapeutics
IAC=IAC
IART=英特格拉生命科学
IBB=纳斯达克生物技术指数
IBBJ=初级生物技术指数ETF
IBCP=独立银行
IBEX=IBEX
IBKR=盈透证券
IBOC=国际银行
IBRX=ImmunityBio
IBTA=2021美国国债指数ETF
IBTB=2022美国国债指数ETF
IBTD=2023美国国债指数ETF
IBTE=2024美国国债指数ETF
IBTF=2025美国国债指数ETF
IBTG=2026美国国债指数ETF
IBTH=2027美国国债指数ETF
IBTI=2028美国国债指数ETF
IBTJ=2029美国国债指数ETF
IBTK=2030美国国债指数ETF
IBTX=独立银行集团
IBUY=EQM在线零售指数ETF
ICBK=County Bancorp
ICFI=ICF国际
ICHR=Ichor Holdings
ICLK=爱点击
ICLN=标普全球清洁能源ETF
ICLR=Icon
ICMB=Investcorp Credit
ICON=艾康尼斯
ICPT=Intercept制药
ICUI=ICU医疗
IDCC=交叉指型科技
IDLB=发展非美低贝塔等权重
IDN=Intellicheck
IDXX=IDEXX实验室
IDYA=IDEAYA生物科学
IEC=Iec电子
IEF=国债7-10年债券指数
IEI=国债3-7年债券指数ETF
IEP=伊坎企业
IESC=IES Holdings
IEUS=MSCI欧洲小盘ETF
IFGL=除美国外发展房地产
IFRX=InflaRx
IFV=赖特国际焦点五指数
IGF=全球基础设施指数ETF
IGIB=美国中间信用债券指数
IGMS=IGM Biosciences
IGOV=世界政府债券指数ETF
IGSB=1-5年美国公司指数ETF
IHRT=iHeartMedia
IHYF=景顺高收益债券因子
III=信息服务
IIIV=i3 Verticals
IIN=IntriCon
IIVI=II-VI
IJT=标普小盘增长指数ETF
IKNA=Ikena Oncology
ILMN=Illumina
ILPT=Industrial Logistics
IMAB=天境生物科技
IMCR=Immunocore
IMCV=晨星中值指数ETF
IMGN=ImmunoGen
IMKTA=安格莱斯市场
IMMP=Immutep
IMMR=浸入科技
IMOS=南茂
IMPL=Impel NeuroPharma
IMRA=IMARA
IMUX=Immunic
INAB=In8bio
INBK=第一互联网
INBX=Inhibrx
INCY=因塞特医疗
INDB=美国独立银行
INDT=INDUS Realty Trust
INDV=Indivior
INDY=Nifty 50指数ETF
INFI=无限制药
INFN=英飞朗
INFR=RARE全球基础设施指数
INGN=Inogen
INMD=InMode
INNV=InnovAge Holding
INO=Inovio制药
INOD=Innodata
INOV=Inovalon控股
INSG=Inseego
INSM=Insmed
INTC=英特尔
INTM=Intermedia Cloud
INTU=财捷
INVA=亚邦丝医疗
INZY=Inozyme Pharma
IONS=伊奥尼斯制药
IOSP=英诺斯派材料
IOVA=Iovance
IPAR=依特香水
IPGP=IPG光电
IPHA=Innate Pharma
IPHI=Inphi
IPKW=纳斯达克国际指数
IPLDP=Interstate电光优先D
IQ=爱奇艺
IRBT=iRobot
IRCP=IRSA Propiedades
IRDM=铱星通讯
IRIX=艾里德克斯
IRTC=iRhythm Technologies
IRWD=Ironwood医药
ISBC=投资者银行
ISDX=战略发展除美指数ETF
ISEE=IVERIC bio
ISEM=景顺战略新兴市场指数
ISHG=世界政府债券指数ETF
ISRG=直觉外科
ISSC=创新软件
ISTB=美国通用1-5年指数ETF
ISTR=Investar Holding
ITCI=Intra-cellular
ITIC=投资者不动产
ITOS=iTeos Therapeutics
ITRI=伊管
ITRM=Iterum Therapeutics
ITRN=Ituran定位和控制
IUS=景顺战略美国指数
IUSB=彭博巴克莱美国通用
IUSG=标普900成长指数ETF
IUSS=战略美国小公司指数
IUSV=标普900价值指数ETF
IVA=Inventiva
IVAC=因特瓦克
IXUS=国家非美可投资市场
JACK=Jack In The Box
JAKK=Jakks Pacific
JAMF=Jamf Holding
JAZZ=爵士制药
JBHT=JB Hunt运输服务
JBLU=捷蓝航空
JBSS=John B. Sanfilippo
JCOM=J2全球通信
JCS=通信系统
JD=京东
JFIN=嘉银金科
JFU=玖富
JG=极光
JJSF=JJSF食品
JKHY=杰克亨利
JNCE=Jounce Therapeutics
JOAN=JOANN
JOBS=前程无忧
JOET=美国质量动力ETF
JOUT=约翰逊户外
JRJC=金融界
JRVR=詹姆斯河集团控股
JSMD=小/中盘增长阿尔法ETF
JSML=小盘成长型阿尔法ETF
KALA=Kala制药
KALU=凯撒铝业
KALV=KalVista制药
KARO=Karooooo
KBAL=金柏国际
KBWB=纳斯达克银行指数ETF
KBWD=金融行业股息收益率
KBWP=纳斯达克财险指数
KBWR=地区银行指数ETF
KBWY=溢价收益率股票REIT
KC=金山云
KDMN=Kadmon Holdings
KDNY=Chinook Therapeutics
KDP=Keurig Dr Pepper
KE=金博尔电子
KEJI=Global X中国中断ETF
KELYA=凯利服务A
KELYB=凯利服务B
KEQU=基瓦尼科技
KFFB=肯塔基第一银行
KFRC=K力
KHC=卡夫亨氏
KIDS=Orthopediatrics
KIRK=Kirklands家具
KLAC=科磊
KLDO=Kaleido Biosciences
KLIC=库力索法半导体
KLTR=Kaltura
KLXE=Klx Energy Services
KMDA=Kamada
KNBE=KnowBe4
KNDI=康迪车业
KNSA=Kiniksa制药
KNSL=Kinsale Capital
KNTE=Kinnate
KOD=Kodiak Sciences
KOPN=高平电子
KPTI=Karyopharm
KREE=惠州吉瑞科技
KRKR=36氪
KRMA=邻近意识公司指数ETF
KRNT=Kornit数码
KRNY=卡尼金融储蓄
KRON=Kronos Bio
KROS=Keros
KRT=Karat Packaging
KRTX=Karuna Therapeutics
KRUS=Kura Sushi USA
KTCC=Key Tronic
KTOS=克瑞拓斯安全防卫
KURA=Kura Oncology
KVHI=KVH通信
KYMR=Kymera Therapeutics
KZR=Kezar生命科学
LABP=Landos Biopharma
LAEC=龙腾
LAKE=雷克兰医疗工业
LAMR=拉马尔户外广告
LANC=兰卡斯特食品
LAND=格莱斯顿田野
LARK=兰德马克银行
LASR=nLIGHT
LAUR=Laureate Education
LAWS=劳森产品
LBAI=拉扎德银行
LBC=Luther Burbank
LBPH=Longboard
LBPS=4D pharma
LBRDA=Liberty Broadband A
LBRDK=Liberty Broadband C
LBRDP=Liberty优先A
LBTYA=自由全球
LBTYB=自由全球B类普通
LBTYK=自由全球C类普通
LCUT=生活时光品牌家具
LDEM=5%发行人上限指数ETF
LDSF=低持续时间战略重点
LECO=林肯电气控股
LEE=李氏企业
LEGH=Legacy住房
LEGN=传奇生物
LEGR=Indxx区块链指数
LESL=Leslie’s
LEVL=Level One Bancorp
LFUS=美国力特保险丝
LGIH=LGI Homes
LGND=Ligand
LGO=Largo Resources
LHCG=LHC集团
LHDX=Lucira Health
LI=理想汽车
LIFE=aTyr制药
LILA=自由拉丁美洲A类
LILAK=自由拉丁美洲C类
LINC=林肯教育服务
LITE=Lumentum控股
LIVN=LivaNova
LIZI=荔枝
LKFN=莱克兰金融
LKOR=公司债券价值指数ETF
LKQ=LKQ汽配
LLNW=烛光网络
LMAT=勒梅特微管医疗
LMBS=第一信任短期机会ETF
LMNL=Liminal BioSciences
LMNR=Limoneira
LMNX=路明克斯
LMRK=Landmark Partners
LMRKP=Landmark优先A
LNDC=Landec
LNT=美国联合能源
LNTH=Lantheus控股
LOB=Live Oak Bancshares
LOCO=El Pollo Loco
LOGC=LogicBio医疗
LOGI=罗技
LOOP=Loop Industries
LOPE=大峡谷教育
LORL=劳拉空间通信
LOTZ=CarLotz
LOVE=The Lovesac
LPLA=LPL投资控股
LPRO=Open Lending
LPSN=LivePerson
LPTX=Leap Therapeutics
LQDT=流动性服务
LRCX=拉姆研究
LRGE=大盘增长ESG ETF
LRMR=Larimar
LSBK=莱克肖尔万通金控
LSCC=莱迪思半导体
LSTR=莱帝运输
LSXMA=Liberty SiriusXM A
LSXMB=Liberty SiriusXM B
LSXMK=Liberty SiriusXM C
LTRPA=Liberty Holdings A
LTRPB=Liberty Holdings B
LULU=露露柠檬运动成衣
LUMO=Lumos Pharma
LUNG=Pulmonx
LVHD=低波动性高股息指数
LVTX=LAVA Therapeutics
LWAY=来福威食品
LX=乐信
LXEH=丽翔教育
LXRX=莱斯康制药
LYFT=Lyft
LYRA=Lyra Therapeutics
LYTS=LSI设备
M00119=Global Indemnity B
M00945=PLX科技存托普通
M01314=Genworth Mortgage
M01317=哈出行
MACK=Merrimack制药
MAGS=马加尔安全系统
MANH=曼哈顿联合软件
MANT=美泰科技
MAR=万豪国际酒店
MASI=麦斯莫医疗
MASS=908 Devices
MAT=美泰
MATW=马修国际
MAXN=Maxeon Solar
MBB=巴克莱美国MBS指数ETF
MBIO=Mustang Bio
MBSD=期限美国抵押支持证券
MBUU=Malibu Boats
MBWM=莫肯特尔银行
MCBC=麦克塔瓦银行
MCBS=MetroCity Bankshares
MCEF=市政基金收入机会ETF
MCFE=Mcafee
MCFT=MasterCraft Boat
MCHI=MSCI中国指数ETF
MCHP=微芯科技
MCHX=马可营销
MCRB=赛里斯治疗
MCRI=莫纳克赌场度假村
MDB=MongoDB
MDCA=MDC合作伙伴
MDIV=资产多元收入指数ETF
MDLZ=亿滋国际
MDRX=麦赛斯医药
MDWD=MediWound
MEDP=Medpace控股
MELI=拉美商业服务
MEOH=梅思恩
MERC=美世国际
MESA=Mesa Air Group
MESO=Mesoblast
METC=Ramaco Resources
MFIN=梅达莲信贷
MGEE=MGE能源
MGI=速汇金国际
MGIC=魔力软件企业集团
MGLN=麦哲伦健康服务
MGNI=Magnite
MGNX=Macrogenics
MGPI=MGP材料
MGRC=麦格拉思租赁
MGTA=Magenta Therapeutics
MGTX=MeiraGTx Holdings
MGYR=马扎尔银行
MHLD=梅登控股
MIDD=米德尔机械
MILN=Indxx千禧主题指数
MIME=Mimecast
MIND=MIND Technology
MINDP=米奇汗姆租赁A类优先
MIRM=Mirum制药
MIST=Milestone制药
MITO=Stealth Bio
MKSI=MKS Instruments
MKTX=爱克森斯控股
MLAB=梅萨医疗
MLCO=新濠博亚娱乐
MLHR=赫尔曼米勒
MLVF=Malvern Bancorp
MMLP=马丁油气
MMSI=美好医疗系统
MMYT=MakeMyTrip
MNDO=思维终端科技
MNKD=曼恩凯德生物医疗
MNOV=美第奇新星生物技术
MNRO=Monro
MNST=怪物饮料
MODV=ModivCare
MOFG=西部第一银行
MOHO=易恒健康
MOLN=Molecular Partners
MOMO=陌陌
MOR=MorphoSys
MORF=Morphic Holding
MORN=晨星信息
MPAA=美国汽车配件
MPB=宾州中部银行
MPWR=芯源系统
MRAM=Everspin
MRBK=Meridian
MRCC=Monroe Capital
MRCY=Mercury Systems
MREO=Mereo Biopharma
MRIN=马林软件
MRLN=马琳商务服务
MRNA=Moderna
MRNS=Marinus制药
MRSN=Mersana Therapeutics
MRTN=马尔登运输
MRUS=Merus
MRVI=Maravai
MRVL=迈威尔科技
MSBI=Midland States
MSEX=米德尔赛克斯水务公司
MSFT=微软
MSON=迷松尼斯医疗器械
MSTR=微策投资
MTCH=Match Group
MTCR=Metacrine
MTEX=寰泰生技
MTLS=Materialise
MTRX=美佳工程
MTSI=MACOM Technology
MU=美光科技
MVIS=维视图像
MXIM=美信集成产品
MYFW=First Western金融
MYGN=万基遗传
MYRG=MYR集团
NAII=天然替代品
NARI=Inari Medical
NATH=纳森连锁餐饮
NATI=美国国家仪器
NAVI=Navient
NBIX=神经分泌生物科学
NBLX=Noble Midstream
NBN=东北银行
NBRV=Nabriva Therapeutics
NBTB=NBT合众银行
NBTX=Nanobiotix
NCMI=国际影像传媒
NCNA=Nucana
NCNO=nCino
NCSM=NCS Multistage
NDAQ=纳斯达克
NDLS=Noodles & Company
NDSN=Nordson
NEOG=纽尔真检测
NERV=米勒娃科学
NEWT=Newtek Business
NEXI=NexImmune
NEXT-1=触控科技
NFBK=Northfield Bancorp
NFE=New Fortress Energy
NFLX=奈飞
NFTY=AlphaDEX台湾指数ETF
NGM=Ngm生物制药
NGMS=Neogames
NH=NantHealth
NICE=NICE
NICK=Nicholas金融
NIU=小牛电动
NKTR=内克塔治疗
NKTX=Nkarta
NLOK=NortonLifeLock
NLTX=Neoleukin医疗
NMFC=New Mountain Finance
NMIH=NMI Holdings
NMRK=Newmark Group
NNBR=NN
NNOX=Nano-x Imaging
NORT=北欧房地产信托
NOVN=Novan
NOVT=Novanta
NPCE=NeuroPace
NRBO=NeuroBo
NRC=国家研究A类普通
NRIM=北沿合众银行
NRIX=Nurix Therapeutics
NSEC=国民保障集团
NSIT=洞察企业
NSSC=纳普科安全技术
NSTG=Nanostring科技
NTAP=NetApp
NTCT=网侦系统
NTES=网易
NTGR=网络齿轮通信
NTIC=北方科技国际
NTLA=Intellia
NTNX=路坦力
NTRA=Natera
NTRS=北方信托
NTUS=纳图斯医疗
NUAN=纽昂斯通讯
NUVA=纽瓦索器材
NVAX=诺瓦瓦克斯医药
NVCR=Novocure
NVDA=英伟达
NVFY=Nova lifestyle
NVIV=Invivo治疗控股
NVMI=新星测量仪器
NWBI=西北银行
NWE=Northwestern
NWFL=诺伍德金融
NWL=纽威品牌
NWLI=国家西方人寿保险
NWPX=西北管道
NWS=新闻集团B
NWSA=新闻集团
NXGN=NextGen Healthcare
NXPI=恩智浦
NXST=耐思星传媒集团
NXTC=NextCure
NXTG=5G和NextG主题指数ETF
NYMT=纽约抵押信托
NYMTN=纽约抵押信托D类优先
NYMTP=纽约抵押信托B类优先
OAS=绿洲石油
OBAS=阿贝斯
OBLN=Obalon Therapeutics
OBNK=Origin Bancorp
OBSV=ObsEva SA
OCC=光缆
OCFC=海洋第一金融
OCSL=Oaktree Specialty
OCUL=Ocular Therapeutix
OCX=Oncocyte
ODFL=统领货运线
ODP=欧迪办公
ODT=Odonate治疗
OFIX=Orthofix Medical
OFLX=欧美佳福莱克斯
OFS=Ofs Capital
OGI=Organigram Holdings
OIIM=凹凸科技
OKTA=Okta
OLD=长期护理指数ETF
OLED=通用显示器
OLK=Olink Holding AB
OLLI=奥利廉价出口控股
OLMA=Olema
OM=Outset Medical
OMAB=北方中心机场
OMCL=全细胞医护科技
OMER=奥麦罗制药
OMP=Oasis Midstream
ON=安森美半导体
ONB=欧德国家银行
ONCR=Oncorus
ONEM=1Life Healthcare
ONEQ=纳斯达克综合指数ETF
ONEW=OneWater Marine
ONVO=Organovo Holdings
OPBK=OP Bancorp
OPCH=Option Care
OPEN=Opendoor
OPI=Office Properties
OPK=OPKO保健
OPRA=欧朋浏览器
OPRT=Oportun Financial
OPT=Opthea
OPTN=OptiNose
ORBC=ORBCOMM轨道通讯系统
ORIC=ORIC制药
ORLY=奥莱利
ORPH=Orphazyme
ORTX=Orchard Therapeutics
OSBC=欧德第二银行
OSIS=OSI系统
OSMT=Osmotica制药
OSTK=Overstock.com
OSUR=奥瑞许科技
OTEX=Open Text
OTG=Otg Exp
OTIC=Otonomy
OTLK=Outlook Therapeutics
OTLY=Oatly Group AB
OTTR=奥特泰尔
OVBC=俄亥俄河谷银行
OVID=Ovid Therapeutics
OXSQ=Oxford Square
OYST=Oyster Point Pharma
OZK=欧扎克银行
OZON=Ozon
PAA=全美平地管道
PAAS=泛美白银
PACB=太平洋生物科学
PACW=西太平洋合众银行
PAGP=Plains GP
PAHC=Phibro Animal Health
PARK=The Parking Reit
PASG=Passage Bio
PATI=爱国者交通控股
PATK=帕特里克工业
PAX=Patria Investments
PAYX=沛齐
PBCT=人民联合金融
PBIP=Prudential Bancorp
PBLT=PurposeBuilt Brands
PBPB=Potbelly
PBYI=彪马生物技术
PCAR=帕卡
PCB=PCB Bancorp
PCH=波特拉奇
PCRX=Pacira生物科学
PCTI=PCTEL
PCTY=Paylocity Holding
PCVX=Vaxcyte
PDBC=最优收益多元商品策略
PDCE=PDC能源
PDCO=帕特森
PDD=拼多多
PDEV=开发选择领导指数ETF
PDFS=PDF方案
PDLB=PDL Community
PDP=技术领导者指数ETF
PDSB=PDS Biotechnology
PEBK=北加利福尼亚国民银行
PEBO=人民合众银行
PEGA=佩格系统
PENN=佩恩国民博彩
PEP=百事
PERI=Perion网络
PETQ=PetIQ
PETS=佩特美德快送
PEY=高股利50指数ETF
PEZ=周期性产品技术领导者
PFBC=保富银行
PFBI=PREMIER金融银行
PFC=Premier Financial
PFF=上市优先和混合证券
PFG=信安金融
PFHD=Professional Holding
PFI=金融技术领导者
PFIN=P&F工业
PFIS=人民金融服务
PFLT=PennantPark
PFM=泛美高股利指数ETF
PFMT=Performant Financial
PFPT=Proofpoint
PFX=PhenixFIN
PGC=皮帕克格拉德斯通金融
PGEN=Precigen
PGJ=金龙中国指数ETF
PGNY=Progyny
PHAR=Pharming Group
PHAS=PhaseBio制药
PHAT=Phathom制药
PHO=OMX美国水指数ETF
PHVS=Pharvaris
PI=Impinj
PICS=PicS
PID=国际高股利指数ETF
PIE=新兴市场技术领导者
PINC=Premier
PIO=OMX全球水指数ETF
PIZ=发达市场技术领导者
PKOH=帕克俄亥俄控股
PKW=回购成就指数ETF
PLAB=福尼克斯
PLAY=戴夫和巴斯特娱乐
PLCE=儿童之家
PLMR=Palomar Holdings
PLPC=预制管线产品
PLRX=Pliant Therapeutics
PLTE=普尔特收购
PLTK=Playtika Holding
PLUS=正羽科技
PLW=国债阶梯指数ETF
PLXS=普雷克萨斯
PLYA=Playa酒店及度假村
PMBC=太平洋商业合众银行
PMVP=Pmv Pharmaceuticals
PNBK=爱国者国家合众银行
PNFP=顶尖金融
PNNT=PennantPark投资
PNQI=纳斯达克互联网指数
PNTG=The Pennant Group
PODD=银休特
POOL=普尔
POSH=Poshmark
POTX=大麻指数ETF
POWI=帕沃英蒂格盛
POWL=鲍威尔工业
PPBI=太平洋第一合众银行
PPC=皮尔格林普拉德
PPD=PPD
PPH=MVIS上市药业25指数
PPIH=Perma-Pipe国际控股
PRAA=PRA Group
PRAH=PRA健康科学
PRAX=Praxis
PRDO=Perdoceo Education
PRFT=Perficient
PRFZ=RAFI美国1500中小指数
PRGS=Progress Software
PRIM=Primoris服务
PRLD=Prelude
PRN=工业技术领先者
PROG=Progenity
PROV=Provident Financial
PRQR=ProQR Therapeutics
PRTA=Prothena
PRTC=Puretech Health
PRTK=Paratek生物制药
PRTS=CarParts.com
PRVA=Privia Health
PSC=美小盘股领先指数ETF
PSCC=小盘股上限消费必需品
PSCD=小盘600/非必需消费品
PSCE=小盘股600上限能量
PSCF=标普小盘600金融股
PSCH=标普小盘600保健股
PSCI=标普小盘600工业股
PSCM=标普小盘股600/材料
PSCT=标普小盘600信息技术
PSCU=标普小盘600公用事业
PSEC=普罗斯佩克特资本
PSET=纳斯达克美国价格指数
PSL=消费必需品技术领导者
PSMT=普尔斯玛特
PSNL=Personalis
PSTX=Poseida Therapeutics
PT=品钛
PTC=PTC
PTCT=Ptc Therapeutics
PTEN=Patterson-UTI能源
PTF=技术领导者指数ETF
PTGX=Protagonist
PTH=医疗技术领导者
PTMN=Portman Ridge
PTNR=合作通信
PTON=Peloton Interactive
PTSI=P.A.M.运输服务
PTVCA=Protective Insurance
PTVCB=Protective保险B
PTVE=Pactiv
PUBM=Pubmatic
PUI=公用事业技术领导者
PULM=Pulmatrix
PUYI=普益财富
PVAC=宾维吉尼亚
PWFL=PowerFleet
PWOD=彭斯-伍茨银行
PXI=能源技术领导者
PXLW=美国像素
PY=纳斯达克美国股东收益
PYCR=Paycor HCM
PYPD=PolyPid
PYPL=贝宝
PYZ=基础材料技术领导者
PZZA=棒约翰
QABA=纳斯达克社区银行指数
QADA=QAD A
QADB=QAD
QAT=MSCI卡塔尔限制指数
QCLN=纳斯达克清洁绿色能源
QCOM=高通
QCRH=QCR控股
QDEL=窥得儿医药
QFIN=360数科
QH=趣活
QIWI=Qiwi
QK=青客
QLC=质量大盘指数ETF
QLI=祁连国际
QLYS=科力斯
QMCO=昆腾数据
QNST=QuinStreet
QQC=NASDAQ100指数ETF
QQD=NASDAQ100指数ETF
QQEW=NASDAQ100市值加权
QQQ=NASDAQ100指数ETF
QQQJ=纳斯达克下一代100ETF
QQQM=NASDAQ100指数ETF
QQQN=纳斯达克Q-50指数ETF
QQQX=Nuveen Nasdaq 100
QQXT=NASDAQ100科技指数
QRTEA=Qurate Retail
QRTEB=Qurate Retail
QRVO=Qorvo
QTEC=NASDAQ100技术指数
QTNT=Quotient
QTRX=Quanterix
QTT=趣头条
QUIK=快辑半导体
QUMU=Qumu
QURE=uniQure
QYLD=NASDAQ100指数ETF
QYLG=纳斯达克半买进V2ETF
RADI=Radius Global
RAIL=FreightCar America
RAIN=Rain Therapeutics
RAPT=RAPT Therapeutics
RARE=Ultragenyx药业
RAVN=雷文工业
RBB=RBB
RBBN=Ribbon
RBCAA=共和银行
RCHR=ArcherDX
RCII=Rent-A-Center
RCKT=Rocket制药
RCKY=洛奇品牌
RCMT=RCM科技
RDFN=Redfin
RDNT=雷网
RDUS=Radius Health
RDVY=纳斯达克股利增长指数
RDWR=Radware
REAL=The RealReal
REDU=瑞思学科英语
REG=丽晶中心
REGI=Renewable能源
REGN=再生元制药
REIT=房地产投资信托ETF
RELL=理查森电子
REPL=Replimune Group
RETA=Reata制药
REYN=Reynolds Consumer
RFAP=滨河动态亚太ETF
RFDI=滨河动态国际发展ETF
RFEM=第一信托动态新兴市场
RFEU=河滨动态欧洲ETF
RFIL=RF工业
RGCO=RGC资源
RGEN=雷普里根
RGLD=皇家黄金
RGLS=Regulus Therapeutics
RGNX=Regenxbio
RGP=资源联合
RICK=RCI Hospitality控股
RIDE=Lordstown
RIGL=里格尔制药
RILY=B. Riley Financial
RING=黄金矿业指数ETF
RIVE=Riverview Financial
RLAY=Relay Therapeutics
RMBS=蓝博士半导体
RMCF=洛矶山巧克力工厂
RMNI=Rimini Street
RMTI=罗克韦尔医药
RNA=Avidity Biosciences
RNDB=Randolph Bancorp
RNDM=发达市场指数
RNDV=美国股票红利选择ETF
RNEM=新兴市场股票选择ETF
RNET=RigNet
RNLC=风险大盘美国股票期权
RNLX=Renalytix AI
RNMC=中档美国股票选择ETF
RNRG=YieldCo和可再生能源
RNSC=风险美国小盘股ETF
RNST=瑞纳萨塔银行
RNWK=瑞尔网路
ROAD=Construction
ROBO=全球机器人与自动化
ROBT=纳斯达克CTA人工智能
ROCK=直布罗陀工业
ROIC=零售成长投资
ROKU=Roku
ROLL=RBC轴承
RONN=RONN Motor Group
ROOT=Root
ROST=罗斯百货
RP=RealPage
RPD=Rapid7
RPHM=Reneo
RPRX=Royalty Pharma
RPTX=Repare
RRBI=Red River Bancshare
RRGB=红罗宾汉堡连琐店
RRR=Red Rock Resorts
RTEP=Red Stone Tax Exempt
RTLR=Rattler Midstream
RTVA=Artiva
RUBY=Rubius Therapeutics
RUHN=如涵
RUN=Sunrun
RUSHA=拉什企业A
RUSHB=拉什企业B
RUTH=鲁斯集团
RVMD=Revolution Medicines
RVNC=Revance Therapeutics
RVSB=里佛维尤银行
RXDX=Prometheus
RXRX=Recursion
RXT=Rackspace Technology
RYAAY=瑞安航空
RYTM=Rhythm制药
SABR=Sabre
SAFM=桑德森农场
SAFT=Safety Insurance
SAGE=Sage Therapeutics
SAIA=Saia
SAIG=安全汽车保险
SALM=塞勒姆传媒集团
SAMG=Silvercrest资产管理
SANA=Sana Biotechnology
SANM=新美亚电子
SASR=桑德斯普林银行
SATS=回声星通信
SBAC=SBA通信
SBBP=Strongbridge
SBCF=佛罗里达海岸线银行
SBGI=辛克莱广播集团
SBLK=星散海运
SBNY=Signature银行
SBNYP=Signature银行优先A
SBRA=Sabra保健
SBSI=南方银行
SBTX=Silverback
SBUX=星巴克
SCCI=斯米克建筑公司
SCHL=学乐集团
SCHN=史尼泽钢铁
SCOR=康姆斯克
SCPH=Scpharmaceuticals
SCPL=SciPlay
SCPS=Scopus BioPharma
SCR=Score Media
SCSC=数码扫描
SCVL=嘉年华鞋业
SCWX=SecureWorks
SCYX=Scynexis
SCZ=欧澳远东小盘指数ETF
SDC=SmileDirectClub
SDG=可持续影响指数ETF
SDGR=Schrodinger
SDVY=中小盘上涨股息指数
SEAC=海易国际
SECO=寺库
SEDG=SolarEdge技术
SEED=奥瑞金种业
SEER=Seer
SEIC=SEI投资
SELB=Selecta生物科学
SENEA=塞内卡食品A
SENEB=塞内卡食品B
SESN=Sesen Bio
SFBS=Servisfirst银行
SFIX=Stitch Fix
SFM=豆芽农贸市场
SFNC=西蒙斯第一国民银行
SFST=南方第一银行
SGA=SAGA通信
SGC=Superior Group
SGEN=Seagen
SGH=SMART Global
SGMO=Sangamo Therapeutics
SGMS=美彩科技
SGMT=Sagimet Biosciences
SGRY=Surgery Partners
SGTX=Sigilon
SHBI=Shore Bancshares
SHC=Sotera
SHEN=谢南多厄电讯
SHLD=保护美国ETF
SHLS=Shoals Technologies
SHOO=史蒂夫・马登
SHV=美国短期国债指数ETF
SHY=美国国债债券指数
SHYF=The Shyft Group
SIBN=SI-BONE
SIEN=Sientra
SIGA=SIGA科技
SIGI=选择性保险
SILC=矽晶电信
SILK=Silk Road Medical
SIMO=慧荣科技
SIOX=Sio Gene Therapies
SIRI=Sirius XM Holdings
SITM=SiTime
SIVB=硅谷银行
SKOR=美国公司债券指数ETF
SKYU=CTA云计算指数2倍做多
SKYW=西空航空
SKYY=ISE CTA云计算指数ETF
SLAB=芯科实验室
SLCT=Select Bancorp
SLDB=Solid Biosciences
SLGL=Sol-gel
SLGN=Silgan控股
SLM=学贷美
SLMBP=SLM信贷B类优先
SLQD=美元流动投资等级指数
SLRC=SLR Investment
SLRX=Salarius制药
SLVO=纳斯达克银备兑106
SMBC=Southern Missouri
SMCI=超微电脑
SMCP=积极管理小盘股ETF
SMHB=小盘高股息2倍做多
SMMT=Summit Therapeutics
SMTC=先科电子
SMXT=Solarmax Technology
SNBR=Sleep Number
SNCR=Synchronoss科技
SNCY=Sun Country Airlines
SND=Smart Sand
SNDL=Sundial Growers
SNDX=Syndax制药
SNEX=StoneX
SNFCA=国民金融抵押
SNLN=美元流动杠杆贷款
SNPS=新思科技
SNSE=Sensei
SNSR=全球物联网主题指数
SNUG=战术增长收入指数ETF
SNY=赛诺菲-安万特
SOCL=社交媒体指数ETF
SOHO=Sotherly Hotels
SOHON=Sotherly Hotels优先D
SOHOO=Sotherly Hotels优先C
SOHU=搜狐
SONM=Sonim Technologies
SONO=Sonos
SOXX=半导体行业指数ETF
SP=SP Plus
SPEL=Spinal Elements
SPFI=South Plains金融
SPI=SPI绿能宝
SPKE=Spark Energy
SPKEP=Spark Energy优先
SPLK=Splunk
SPNE=SeaSpine控股
SPNS=智人国际
SPOK=Spok Holdings
SPPI=光谱制药
SPQQ=Siren大盘混合指数ETF
SPRB=Spruce
SPRO=Spero治疗
SPSC=SPS商贸
SPTN=SpartanNash
SPWH=型男仓库控股
SPWR=SunPower
SQLV=小盘质量价值指数
SQQQ=NASDAQ100三倍做空
SRAC=Stable Road
SRAM=SRAM国际
SRCE=第一源银行
SRCL=消毒循环
SRDX=苏尔医疗诊断
SRET=全球超级股息REIT
SREV=Servicesource国际
SRGA=Surgalign
SRPT=Sarepta医疗
SRRA=Sierra Oncology
SRRK=Scholar Rock Holding
SRVA=Sirva
SSB=South State
SSBI=萨米特州立银行
SSLP=Smart Sand Partners
SSNC=SS&C技术控股
SSP=EW史立普斯报业
SSRM=SSR Mining
SSYS=Stratasys
STAA=斯达外科手术
STAY=Extended Stay
STBA=S&T银行
STCN=Steel Connect
STEP=Stepstone Group
STFC=国家汽车金融
STIM=Neuronetics
STKL=SunOpta食业
STLD=钢铁动力
STMP=斯坦普斯网站
STNE=StoneCo
STOK=Stoke Therapeutics
STRA=战略教育
STRL=斯特林建筑
STRO=Sutro Biopharma
STRR=Star Equity
STRS=Stratus Properties
STRT=Strattec Security
STSA=Satsuma制药
STTK=Shattuck
STX=希捷科技
STXB=Spirit of Texas
SUMO=Sumo Logic
SUNS=SLR Senior
SUPN=Supernus制药
SURF=Surface Oncology
SUSB=公司ESG焦点指数ETF
SUSC=MSCI美企ESG关注指数
SUSL=扩展ESG领导者指数ETF
SVA=科兴生物
SVC=Service Properties
SVMK=SVMK
SVRA=Savara
SVVC=Firsthand Technology
SWAV=ShockWave Medical
SWBI=Smith & Wesson品牌
SWIM=Latham Group
SWIR=希拉无线
SWKS=思佳讯
SWTX=SpringWorks
SY=新氧科技
SYBT=Stock Yards Bancorp
SYKE=赛科斯企业
SYNA=Synaptics
SYNH=Syneos Health
SYNL=Synalloy钢铁
SYPR=Sypris科技
SYRS=Syros医药
TA=TravelCenters
TACT=Transact技术
TARS=Tarsus
TASK=TaskUs
TAST=卡罗尔斯饭店
TATT=TAT科技
TBBK=The Bancorp
TBIO=Translate Bio
TBK=Triumph Bancorp
TBNK=Territorial银行
TBPH=Theravance生物制药
TCBI=德州资本银行
TCBIP=德州资本银行优先A
TCBK=特里科银行
TCDA=Tricida
TCF=Tcf Financial
TCMD=Tactile Systems
TCOM=携程集团
TCON=Tracon制药
TCPC=TCP Capital
TCRR=Tcr2 Therapeutics
TCRX=TScan Therapeutics
TDIV=技术股息指数ETF
TDUP=ThredUp
TEAM=Atlassian
TECH=Bio-Techne
TECTP=Tectonic金融优先B
TEDU=达内教育
TELA=TELA Bio
TENB=Tenable Holdings
TER=泰瑞达
TERN=Terns
TESS=特斯科技术
TFSL=TFS金融
TGA=环球能源
THFF=第一财务
THRM=Gentherm
TIG=Trean Insurance
TIGO=米雷康姆国际移动通信
TIGR=老虎证券
TIL=Instil Bio
TILE=Interface
TITN=泰坦机械
TLC=台湾微脂体
TLGT=Teligent
TLIS=Talis Biomedical
TLND=拓蓝
TLRY=Tilray
TLS=Telos
TLSA=Tiziana生命科学
TLT=国债20年以上债券指数
TMCI=Treace Medical
TMDX=TransMedics Group
TMUS=T-Mobile US
TNDM=糖尿病保健
TNXP=Tonix医药控股
TOUR=途牛
TOWN=唐恩银行
TPCO=Tribune Publishing
TPIC=TPI复合材料
TPTX=Turning Point医疗
TQQQ=NASDAQ100三倍做多
TREE=LendingTree
TRHC=Tabula Rasa
TRIB=三一生物科技
TRIN=Trinity Capital
TRIP=猫途鹰
TRIT=Triterras
TRMB=天宝导航
TRMD=Torm
TRMK=Trustmark银行
TRNS=特斯卡
TROW=普信集团
TRS=瑞奇包装系统
TRST=梅隆银行
TRUE=Truecar
TRUP=Trupanion
TRVG=Trivago
TRVI=Trevi Therapeutics
TRVN=Trevena
TSBK=天木蓝银行
TSC=三态资本控股
TSCAP=三态资本控股优先A
TSCBP=三态资本控股优先B
TSCO=牵引机供销
TSEM=Tower半导体
TSHA=Taysha Gene
TSLA=特斯拉
TSP=图森未来
TTD=The Trade Desk
TTEC=TTEC Holdings
TTEK=德照科技
TTGT=Techtarget旅游
TTMI=TTM科技
TTOO=T2 Biosystems
TTWO=双互动软件
TUR=土耳其IMI 25/50指数
TURN=180 Degree Capital
TUSA=AlphaDEX美国总市场
TUSK=Mammoth Energy
TVTX=Travere Therapeutic
TVTY=Tivity Health
TW=Tradeweb Markets
TWIN=双环
TWOU=2u
TWST=Twist Bioscience
TXG=10x Genomics
TXMD=Therapeuticsmd
TXN=德州仪器
TXRH=德州公路酒吧
TZOO=旅行动物园
UAE=阿联酋限制指数ETF
UAL=联合航空控股
UBFO=联合安全银行
UBOH=联合货币中心银行
UBSI=联合银行
UBX=Unity Biotechnology
UCBI=美国社区银行
UCL=优克联
UCTT=超科林半导体
UCYB=网络安全2倍做多ETF
UEIC=统一电子
UEPS=UEPS科技
UFCS=联合火险
UFPI=UFP Industries
UG=守护者联盟
UHAL=爱美可
ULBI=Ultralife
ULCC=Frontier Group
ULH=环球物流控股
ULTA=犹他美容
UMBF=UMB金融
UMPQ=Umpqua控股
UNAM=尤尼柯北美保险
UNB=联合银行
UNIT=Uniti Group
UNTY=联合银行
UPC=大自然药业
UPLD=Upland Software
UPST=Upstart
UPWK=Upwork
URBN=都市户外
URGN=乌龙制药
USAK=美国卡车
USAP=通用不锈钢和合金制品
USIG=美林银行美国公司指数
USLB=罗素1000低贝塔ETF
USLM=美国灰矿建材
USMC=纳斯达克美国巨型股票
USOI=X-Links原油股份ETN
USXF=选择ESG筛选指数ETF
UTHR=联合治疗
UTMD=犹他医疗产品
UTSI=UT斯达康
UVSP=Univest金融
UXIN=优信
VACC=Vaccitech
VALN=Valneva SE
VBLT=Vascular Biogenics
VBND=核心美国债券指数ETF
VBTX=Veritex
VC=伟世通
VCIT=巴克莱美国企业债券
VCLT=巴克莱美国长期企业
VCNX=Vaccinex
VCSH=美国1-5年公司债券
VCTR=Victory Capital
VCYT=Veracyte
VECO=维易科精密仪器
VECT=VectivBio Holding
VEON=VEON
VERA=Vera Therapeutics
VERI=Veritone
VERO=Venus Concept
VERX=Vertex
VETS=军事时报最佳VETS指数
VG=Vonage通信
VGIT=美国3-10年国债指数
VGLT=彭博美国财政部指数
VGSH=美国1-3年政府浮动
VIAC=ViacomCBS
VIACA=ViacomCBS A
VIAV=Viavi Solutions
VICR=Vicor电子
VIDI=核心国际股票指数ETF
VIGI=纳斯达克高股利ETF
VINP=Vinci Partners
VIR=Vir Biotechnology
VIRC=Virco制造
VIRT=Virtu Financial
VIRX=Viracta Therapeutics
VISN=Gyroscope
VIVO=美鼎生物
VLDR=Velodyne Lidar
VLGEA=Village Super Market
VLY=硅谷国家银行
VLYPO=Valley National优先B
VLYPP=硅谷国家银行优先A
VMBS=美国MBS浮动经调整
VNDA=万达生物制药
VNET=世纪互联
VNOM=Viper Energy
VNQI=标普全球房价指数ETF
VOD=沃达丰
VONE=罗素1000指数ETF
VONG=罗素1000增长指数ETF
VONV=罗素1000价值指数ETF
VOR=Vor Biopharma
VOXX=奥迪富斯
VPN=REITs和数字基础设施
VPRL=Vista支持和物流
VRA=Vera Bradley
VRAY=Viewray
VRCA=Verrica制药
VREX=Varex Imaging
VRIG=景顺浮动利率投资级
VRM=Vroom
VRNA=维罗纳制药
VRNS=Varonis Systems
VRNT=Verint系统
VRSK=Verisk分析
VRSN=威瑞信
VRTS=维德思投资
VRTX=福泰制药
VSAT=卫讯公司
VSDA=股利加速器ETF
VSEC=VSE技术服务
VSMV=美国多因素最小波动率
VSTA=Vasta Platform
VSTM=Verastem
VTC=美国企业债券指数
VTEC=Valtech
VTHR=罗素3000指数ETF
VTIP=美国国债TIPS 0-5年
VTRN=退伍军人选择指数ETF
VTRS=Viatris
VTRU=Vitru
VTVT=vTv Therapeutics
VTWG=罗素2000增长指数ETF
VTWO=罗素2000指数ETF
VTWV=罗素2000价值指数ETF
VUSE=核心美国股票指数ETF
VWOB=彭博政府上限指数ETF
VWTR=Vidler Water
VXUS=除美国外全球全市值
VYGR=Voyager Therapeutics
VYMI=富时环球高股息收益率
VYNE=VYNE
VZIO-1=Vizio
WABC=西美银行
WAFD=华盛顿联邦储蓄
WASH=华盛顿信托银行
WB=微博
WBA=沃尔格林联合博姿
WBND=西方资产总回报
WCBR=网络安全基金ETF
WCLD=新兴云指数ETF
WDAY=Workday
WDC=西部数据
WDFC=WD-40
WEN=温迪
WERN=沃纳企业
WETF=WisdomTree投资
WEYS=韦科鞋业
WHF=WhiteHorse Finance
WIFI=Boingo无线网
WIMI=微美全息
WINA=威玛克工贸
WINC=西部资产短期收入
WING=Wingstop
WIRE=Encore电气线路
WISH=ContextLogic
WIX=Wix.com
WKEY=WISeKey
WLDN=Willdan集团
WLFC=威利斯金融租赁
WLTW=Willis Towers Watson
WMG=华纳音乐
WNEB=Western New England
WOOD=全球木材及林业指数
WOOF=Petco Health
WPRT=西港燃料
WRLD=环球验收
WSBC=韦斯银行
WSBF=沃特财务
WSFS=WSFS金融
WSTG=赛德科技
WTBA=West Bancorporation
WTFC=信达金融
WTRE=Watford Holdings
WTREP=Watford优先
WVE=Wave Life Sciences
WVFC=Wvs金融
WW=慧俪轻体
WWD=伍德沃德
WYNN=永利度假村
XBIT=Xbiotech
XEL=埃克西尔能源
XELB=Xcel Brands
XENE=Xenon制药
XENT=Intersect Ent
XERS=Xeris制药
XFOR=X4制药
XGN=Exagen
XLNX=赛灵思
XLRN=Acceleron制药
XM=Qualtrics国际
XNCR=Xencor
XNET=迅雷
XOG=Extraction Oil & Gas
XOMA=标记临床研究
XOMAO=标记临床研究B类优先
XONE=The Exone
XP=XP
XPER=Xperi Holding
XRAY=登士柏国际
XT=晨星指数技术指数
YELL=Yellow
YI=1药网
YJ=云集
YLDE=股利策略ESG ETF
YMAB=Y-mAbs Therapeutics
YNDX=Yandex
YORW=The York Water
YQ=一起教育科技
YY=欢聚
Z=Zillow Group C
ZBRA=斑马技术
ZEAL=Zealand Pharma
ZEUS=奥林匹克钢铁
ZG=Zillow Group A
ZGNX=Zogenix
ZI=ZoomInfo
ZION=齐昂银行
ZIXI=Zix
ZLAB=再鼎医药
ZM=Zoom Video通讯
ZNGA=Zynga
ZNTL=Zentalis
ZS=Zscaler
ZUMZ=Zumiez
ZVO=Zovio
ZY=Zymergen
ZYNE=Zynerba制药
[name_184_186]
ConfigVer=20210427_1915373406
AACO=Advancit
AACP=Aeon Acquisition
AACQ=Artius Acquisition
ABCO=Able Brands
ABEO=Abeona Therapeutics
ABGI=ABG Acquisition
ABIO=方舟生物医药
ABVC-2=ABVC BioPharma
ABWN-1=Airborne Wireless
ACAC=Acies
ACAH=Atlantic Coastal
ACAM=Acamar Partners
ACBA=Ace Global
ACER=Acer医疗
ACEV=Ace Convergence
ACHV=Achieve Life
ACNB=ACNB
ACQR=Independence
ACST=Acasti制药
ACTC=Arclight Clean
ACTD=ArcLight Clean
ACVA=ACV Auctions
ADER=26 Capital
ADIL=Adial制药
ADMA=Adma生物制品
ADMP=Adamis制药
ADN=Advent Technologies
ADOC=Edoc Acquisition
ADTX=ADiTx Therapeutics
ADV=Advantage Solutions
ADXN=Addex Therapeutics
ADXS=Advaxis
AEAC=Authentic Equity
AEHL=Antelope Enterprise
AEHR=Aehr测试系统
AEI=Alset EHome
AEMD=Aethlon Medical
AESE=联合电子竞技娱乐
AEYE=AudioEye
AEZS=依特钠
AFAC=Arena Fortify
AFAQ=AF Acquisition
AFBI=Affinity Bancshares
AGBA=AGBA Acquisition
AGC=Altimeter
AGEN=艾吉纳斯
AGFY=Agrify
AGGR=Agile Growth
AGMH=安高盟
AGRI=AgriFORCE Growing
AGRX=Agile Therapeutics
AHAC=Alpha Healthcare
AHCO=AdaptHealth
AHIT=Corix Bioscience
AHPI=联合保健产品
AIDM=Aegis Identity
AIHS=爱鸿森
AIKI=AIkido Pharma
AIRG=Airgain
AIRT=Air T
AJSB=Ajs Bancorp
AKIC=Sports Ventures
AKOM=Aerkomm
AKTS=Akoustis技术
AKTX=Akari Therapeutics
AKU=Akumin
ALAC=Alberton收购
ALBO=Albireo Pharma
ALDX=Aldeyra Therapeutics
ALF=Alfi
ALPA=Alpha Healthcare
ALPC=Alpha Investment
ALRS=Alerus Financial
ALTA=Altabancorp
ALTE=Altitude
ALTM=Altus Midstream
ALTO=Alto Ingredients
ALTP=Altamont Pharma
ALTT=Altitude
ALTU=Altitude
ALYA=Alithya Group
AMAO=American
AMCI=AMCI Acquisition
AMD=AMD
AMEH=阿波罗医疗控股
AMHC=Amplitude Healthcare
AMPG=AmpliTech Group
AMST=Amesite
ANDA=Andina收购
ANEB=Anebulo
ANIX=Anixa Biosciences
ANY=Sphere 3d
ANZU=Anzu Special
AOPI=ALDA办公物业
APAC=StoneBridge
APCX=AppTech
APDN=DNA Sciences
APOP=Cellect生物科技
APPH=AppHarvest
APPS=Digital Turbine
APTM=Alpha Partners
APTO=Aptose生物科技
APXT=Apex技术收购
AQB=AquaBounty
AQMS=Aqua Metals
ARBG=Aequi Acquisition
ARDS=Aridis制药
AREC=美国资源
ARK=5G Edge
ARKO=ARKO
ARMT=Ameri Metro
ARPO=Aerpio制药
ARRW=Arrowroot
ARTA=Artisan
ARTE=Artemis Strategic
ARTL=Artelo Biosciences
ARTW=自流资源
ARYA=Arya Sciences
ARYD=ARYA Sciences
ASAX=Astrea Acquisition
ASLE=AerSale
ASMB=Assembly生物
ASPC=Alpha Capital
ASPU=Aspen集团
ASTC=Astrotech
ASTS=AST SpaceMobile
ASUR=福景网络
ATCX=Atlas Technical
ATEX=Anterix
ATHE=Alterity医疗
ATHX=Athersys
ATIF=亚洲时代控股
ATLO=艾姆斯国家
ATNF=180 Life
ATOM=Atomera
ATOS=Atossa Therapeutics
ATRS=安塔尔制药
ATSP=Archimedes Tech SPAC
ATVC=Tribe Capital
ATWO=Acies Acquisition
ATXG=盈喜集团
ATXI=Avenue Therapeutics
AURC=Aurora Acquisition
AURV=Aurvandil
AUTO=AutoWeb
AUUD=Auddia
AUVI=Applied Uv
AVAC=Avalon Acquisition
AVCO=Avalon Globocare
AVCT=American Virtual
AVEA=Avanea Energy
AVEO=AVEO制药
AVGR=Avinger
AVXL=Anavex Life Sciences
AWH=Aspira
AXAS=Abraxas石油
AXDX=Accelr科技
AXGN=Axogen
AYRO=AYRO
AYTU=Aytu BioPharma
AZRX=AzurRx BioPharma
BAOS=宝盛传媒
BAPI=Baristas Coffee
BBCP=Concrete Pumping
BBI=Brickell Biotech
BBIG=Vinco
BCAC=Brookline Capital
BCDA=Biocardia
BCHT=奔财科技
BCLI=头脑风暴细胞治疗
BCOW=1895威斯康星
BCTA=B Capital
BCTG=Bctg Acquisition
BCTX=BriaCell
BCYP=Big Cypress
BDS=筑梦之星
BDSI=BioDelivery科学国际
BEEM=Beam
BENE=Benessere
BFC=Bank First
BFI=BurgerFi
BFL=Bankflorida
BFRA=Biofrontera
BHAT=蓝帽子
BHSE=Bull Horn
BHTG=BioHiTech Global
BIAC=BI Acquisition
BICX-1=BioCorRx
BIMI=博琪医药
BIOC=Biocept
BIOL=拜拉斯
BIOT=Biotech Acquisition
BIVI=BioVie
BKSC=南卡罗来纳银行
BKSW=佰康生物科技
BKYI=Bio-key国际
BLFS=BioLife Solutions
BLGO-1=BioLargo
BLIN=Bridgeline数字
BLKS=Blackstratus, Inc.
BLNG=Belong Acquisition
BLNK=Blink Charging
BLRX=BioLineRx
BLSA=Bcls Acquisition
BLTS=Bright Lights
BLUW=Blue Water
BMRA=Biomerica
BMRC=马林银行
BNGO=Bionano Genomics
BNKL=Bionik实验室
BNL.=天美生物
BNSO=恒异电子
BNTC=Benitec Biopharma
BOMN=Boston Omaha
BOSC=BOS科技
BOTJ=詹姆斯金融银行
BOWX=Bowx Acquisition
BOXL=宝视来
BPTH=Bio-Path Holdings
BPTS=Biophytis
BREZ=Breeze Holdings
BRIG=Brigantine
BRIV=B. Riley Principal
BRLI=Brilliant
BROG=Brooge Energy
BRPA=Big Rock Partners
BRPM=B. Riley Principal
BRQS=播思通讯
BRTX=Biorestorative
BRYT=BrightSpark
BSBK=Bogota Financial
BSGM=BioSig Technologies
BSKY=Big Sky Growth
BSPC=Bsp Acquisition
BSPE=Bespoke Capital
BTAI=Bioxcel Therapeutics
BTAQ=Burgundy Technology
BTBT=比特数字
BTNB=Bridgetown 2
BTWN=Bridgetown
BVXV=Biondvax制药
BWAC=Better World
BWB=Bridgewater
BWEN=Broadwind
BWMX=Betterware
BXRX=Baudax Bio
BYFC=百老汇金融
BYNO=Bynordic
BYSI=万春医药
BYTS=BYTE Acquisition
CAAS=中汽系统
CABN=Carbon科学
CADC-2=Color Star
CAHC=CA Healthcare
CAIN=Cain Acquisition
CALQ=Callodine
CAPA=Highcape Capital
CAPR=Capricor
CARH=爱车小屋
CARV=卡弗储蓄
CASI=CASI制药
CATC=Cambridge Bancorp
CATL=Category Leader
CAVU=CAVU Technology
CBAY=Cymabay Therapeutics
CBIO=Catalyst Biosciences
CBLI=克利夫兰生物实验室
CBMB=CBM Bancorp
CBRG=Chain Bridge I
CCNC=码链新大陆
CCRC=泰盈科技
CDEV=百年资源开发
CDMO=Avid Bioservices
CDTG=城道通环保
CDXC=Chromadex
CELC=Celcuity
CELH=Celsius控股
CEMI=Chembio诊断
CENH=Centricus
CENQ=CENAQ Energy
CERC=Cerecor
CERE=Cerevel Therapeutics
CETX=Cemtrex
CETXP=Cemtrex优先
CFAC=CF Finance
CFBK=中央联储
CFFE=CF Acquisition
CFFS=CF Acquisition
CFIV=CF Acquisition
CFRX=Contrafect
CFV=CF Acquisition
CFVI=CF Acquisition
CGRN=Capstone Green
CGWB=格旺中国
CHCI=康斯托克控股
CHEK=Check-cap
CHFS=CHF Solutions
CHNR=中国天然资源
CHPM=CHP Merger
CHSN=香颂国际
CHWA=CHW Acquisition
CIIG=CIIG Capital
CIVB=Civista Bancshares
CJJD=九洲大药房
CKPT=Checkpoint医疗
CLBS=Caladrius生物科学
CLDB=Cortland Bancorp
CLEU=华夏博雅
CLGN=Collplant生物技术
CLIR=ClearSign
CLNN=Clene
CLOE=Clover Leaf
CLPS=华钦科技
CLPT=ClearPoint Neuro
CLRB=Cellectar
CLRM=Clarim Acquisition
CLRO=ClearOne通讯
CLSK=CleanSpark
CLSN=克莱瑞恩
CLST=Catalyst Bancorp
CLVR=Clever Leaves
CLWT=欧陆科仪
CMII=CM Life Sciences
CMLF=Cm Life
CMLT=CM Life Sciences
CMMB=Chemomab
CNAQ=Chardan NexTech
CNET=中网载线
CNEY=中北能
CNNB=Cincinnati
CNSP=CNS Pharmaceuticals
CNTQ=Chardan NexTech
CNTY=世纪赌场
COCP=Cocrystal Pharma
CODA=Coda Octopus Group
CODX=Co-diagnostics
COFS=ChoiceOne Financial
COLI=Colicity
COMS=ComSovereign
CONX=Conx
COOL=Corner Growth
COOP=Mr. Cooper Group
CORT=Corcept医疗
COVA=COVA Acquisition
CPAR=Catalyst Partners
CPRX=催化剂制药
CPSH=Cps科技
CPUL=Compulab
CRDF=Cardiff Oncology
CREG=中国循环能源
CREX=Creative Realities
CRKN=Crown
CRSA=Crescent Acquisition
CRTD=Creatd
CRWS=Crown Crafts制衣
CRZN=Corazon Capital
CSBR=冠军肿瘤
CSCA=基岩资本
CSCW=Color Star
CSIC=Cornerstone
CTAQ=Carney Technology
CTHR=诗思（香港）
CTIB=Yunhong CTI
CTIC=CTI BioPharma
CTRM=Castor Maritime
CTSO=Cytosorbents
CTXR=Citius
CUE=Cue生物制药
CUEN=Cuentas
CULL=Cullman Bancorp
CURI=CuriosityStream
CVCY=中央谷地
CVV=CVD设备
CWBR=CohBar
CXDO=Crexendo
CYAN=赛安诺科技
CYCC=赛拉喜
CYCCP=赛拉喜优先
CYRN=CYREN
CYRX=Cryoport
CYTH=Cyclo
CZNC=市民北方
DAIO=Data I/O
DARE=Dare Bioscience
DBDR=Roman Dbdr
DBGI=Digital Brands Group
DCLN=U.s. Dry Cleaning
DCRB=Decarbonization
DCRC=Decarbonization
DCRD=Decarbonization
DCRN=Decarbonization Plus
DCTH=迪卡斯
DDMX=DD3 Acquisition
DDOC=Dermadoctor
DENN=丹尼快餐店
DFFN=Diffusion
DFHT=Deerfield Healthcare
DFPH=DFP Healthcare
DGAS=Gas Ships
DGLY=Digital Ally
DGNS=Dragoneer
DGNU=Dragoneer Growth
DGON=Black Dragon
DHBC=DHB Capital
DHCA=DHC Acquisition
DHHC=DiamondHead Holdings
DIII=DD3 Acquisition
DILA=DILA Capital
DISA=Disruptive
DIST=Distoken
DJCO=日报期刊
DKDCA=Data Knights
DLCA=Deep Lake Capital
DLHC=DLH控股
DLPN=Dolphin娱乐
DMAC=Diamedica疗法
DMTK=DermTech
DOIT=Do It Again
DRIO=DarioHealth
DSAC=Duddell Street
DSGT=DSG Global
DSKE=Daseke
DTHR-1=Dthera Sciences
DTOC=Digital
DTSS=数海信息
DTST=Data Storage
DUNE=Dune Acquisition
DUOT=Duos Technologies
DVAX=德纳维制药
DYAI=Dyadic国际
DYNT=Dynatronics
DZSI=DZS
EAC=Edify Acquisition
EARS=Auris Medical
EAST=Eastside Distilling
EBAC=European Biotech
EBET=Esports Technologies
EDRY=EuroDry
EDSA=Edesa生物技术
EDTK=王道
EDTX=Edtechx
EEIQ=Elite Education
EFCT=Efactor Group
EFOI=核心能源
EGAN=eGain
EGBN=伊格尔合众银行
EGLX=Enthusiast Gaming
EHR=Energy Hunter
EIPA=EIP Acquisition
EJFA=EJF Acquisition
EJH=e家快服
EKSO=Ekso Bionics
ELDN=Eledon制药
ELSE=伊莱克森
ELTK=Eltek
ELYS=Elys Game
EMCF=恩克莱尔金融
ENFA=890 5th Avenue
ENG=ENG环球
ENLV=Enlivex医疗
ENNV=ECP Environmental
ENOB=Enochian Biosciences
ENTX=Entera Bio
ENVB=Enveric Biosciences
ENVI=Environmental
EOSE=Eos Energy
EPHY=Epiphany Technology
EPIX=Essa制药
EPSN=Epsilon Energy
EQOS=Diginex
ERES=East Resources
ERF-1=Erf无线
ESBK=埃尔迈拉储蓄银行
ESEA=欧海
ESQ=Esquire Financial
ESSC=East Stone
ESSF=Etre Reit
ESTA=Establishment Labs
ESXB=社区银行家信托
ETAC=E.merge Technology
EUCR=Eucrates Biomedical
EUSG=European Sustainable
EVAX=Evaxion Biotech
EVFM=Evofem Biosciences
EVOJ=Evo Acquisition
EVOK=Evoke Pharma
EVOL=进化系统
EXAC=Excolere
EXAS=精密科学
EXPC=Experience
EYEG=Eyegate制药
EYEN=Eyenovia
EYES=Second Sight医疗产品
EZGO=易电行
FAMI=农米良品
FAT=Fat Brands
FBIO=Fortress Biotech
FBIOP=FortressBiotech优先A
FBOX=Fit Boxx Holdings
FCAC=Falcon Capital
FCAP=第一资本
FCBP=First Choice Bancorp
FCCO=第一社区
FCST=FreeCast
FCUV-1=Focus Universal
FEGI=未来教育
FENC=Fennec制药
FFBW=FFBW
FFHL=富维薄膜
FIII=Forum Merger Iii
FINM=Marlin Technology
FKWL=Franklin Wireless
FLAC=Frazier Lifesciences
FLGC=Flora Growth
FLIC=长岛第一
FLL=Full House Resorts
FLMN=Falcon Minerals
FLRZ=F5 Finishes
FLSH=VIDA FLaSH
FLUX=Flux Power控股
FMAO=Farmers & Merchants
FMIV=Forum Merger IV
FMNB=Farmers National
FNCB=FNCB Bancorp
FONR=福纳
FORA=Forian
FORD=福沃德工业
FORE=Foresight
FOTV=FOTV媒体网络
FOXW=FoxWayne
FPAY=Flexshopper
FRAF=富兰克林金融服务
FREE=Whole Earth
FRHC=Freedom Holding
FRON=Frontier
FRSG=First Reserve
FRSX=Foresight Autonomous
FRW=PWP Forward
FSAC=Foresite Life
FSBW=FS银行
FSEA=First Seacoast
FSFG=第一储蓄金融
FSII=FS Development
FSRV=FinServ Acquisition
FSRX=FinServ
FSSI=Fortistar
FSTX=F-star Therapeutics
FTAA=FTAC Athena
FTCV=Fintech
FTHM=Fathom Holdings
FTIV=Fintech
FTOC=Ftac Olympus
FTPA=FTAC Parnassus
FTVI=FinTech
FUSB=First US Bancshares
FUV=Arcimoto
FVAM=5:01 Acquisition
FVCB=FVCBankcorp
FVE=五星高级生活
FWAA=Fifth Wall
FWAB=Fifth Wall
FWAC=Fifth Wall
FXNC=First National
GACQ=Global Consumer
GALT=Galectin治疗
GAMC=Golden Arrow
GAME=Torque Esports
GAN=GAN
GBNH=Greenbrook TMS
GBNY=Generations
GBOX=GreenBox POS
GBPT=Globe Photos
GBRG=Goldenbridge
GCAC=Growth Capital
GCBC=格林县万通金控
GCMG=Gcm Grosvenor
GDYN=Grid Dynamics
GEFA=GEF Acquisition
GELT=将军农业
GENE=基因技术
GEVO=Gevo
GFLD=Gefen Landa
GGAL=加利西亚金融
GGGV=G3 VRM Acquisition
GGMC=Glenfarne Merger
GGPI=Gores Guggenheim
GHAC=Gaming
GHSI=Guardion健康科学
GHVI=Gores
GIF=GigCapital6
GIG=GigCapital4
GIGM=和信超媒体
GIIX=Gores Holdings VIII
GIPR=Generation Income
GIW=GigInternational1
GLAQ=Globis Acquisition
GLBL=Cartesian Growth
GLBS=Globus海运
GLBZ=格伦伯尼万通金控
GLEE=Gladstone
GLG=铜道控股
GLHA=Glass Houses
GLMD=Galmed
GLSI=Greenwich
GLSPT=Global Spac
GMBL=电子竞技娱乐
GMBT=Queen's Gambit
GMGI=Golden Matrix Group
GMII=Gores Metropoulos
GMWX=Gameworks
GNAC=Group Nine
GNOG=Golden Nugget Online
GNPX=Genprex
GNRS=Greenrose
GNSS=Genasys
GNUS=Genius Brands
GOEV=Canoo
GOVX=GeoVax Labs
GOXS=光合星球
GP=Greenpower Motor
GPAC=Global Partner
GPAT=GP-Act III
GPCO=Golden Path
GRBK=Green Brick
GRCY=Greencity
GRFM=天下农庄
GRIL=Muscle Maker
GRNQ=Greenpro Capital
GRNV=绿景
GROW=美国全球投资者
GRSV=Gores Holdings V
GRVI=Grove
GRVY=重力商业
GRWG=GrowGeneration
GSAQ=Global Synergy
GSEV=Gores Holdings
GSMG=耀世星辉
GTBP=GT Biopharma
GTEC=格陵兰科技控股
GTIM=恋上餐厅
GTPA=Gores Technology
GTPB=Gores Technology
GTYH=GTY Technology
GVP=GSE系统
GWAC=Good Works
GWGH=GWG Holdings
GWII=Good Works II
GXGX=GX收购
GXII=GX Acquisition
GYRO=旋翼物业
HAAC=Health Assurance
HAPP=幸福来
HBMD=Howard Bancorp
HBP=Huttig Building
HCAQ=HealthCor Catalio
HCAR=Healthcare Services
HCCC=Healthcare Capital
HCCR=HighCape Capital
HCDI=Harbor Custom
HCIC=Hennessy Capital
HCII=Hudson Executive
HCMA=HCM Acquisition
HCNE=Jaws Hurricane
HCVI=Hennessy Capital
HCXX=Healthcare Merger
HDCC=Hunting Dog Capital
HDSN=哈德森科技
HEC=Hudson Executive
HEPA=Hepion制药
HERA=FTAC Hera
HFBL=Home Federal Bancorp
HFFG=HF Foods
HGBL=Heritage Global
HGEN=Humanigen
HGSH=汉广厦房地产
HHGC=HHG Capital
HIGB=H.I.G. Acquisition
HIHO=骇维金属加工控股
HIII=Hudson Executive
HITI=High Tide
HITM=Hightimes Holding
HJLI=Hancock Jaffe实验
HKIT=海天网络
HLAH=Hamilton Lane
HLXA=Helix
HMCO=HumanCo Acquisition
HNNA=Hennessy Advisors
HNRG=Hallador能源
HOFV=Hall of Fame
HOL=Holicity
HOLO=Hologram
HOTH=Hoth Therapeutics
HQI=HireQuest
HRDG=华瑞国际
HROW=Harrow Health
HRTX=Heron Therapeutics
HSAQ=Health Sciences
HSDT=Helius Medical
HSKA=赫斯卡医疗
HSTO=Histogen
HTBX=热生物制剂
HTGM=Htg分子诊断
HTOO=Fusion Fuel Green
HUDI=华迪国际
HUGE=FSD Pharma
HUMC=Anthropos Capital
HUSN=圣盈信管理咨询
HVBC=HV Bancorp
HWEL=Healthwell
HYAC=Haymaker III
HYJF=汇盈金控
HYMC=Hycroft矿业控股
HYRE=HyreCar
HZ=合众e贷
ICAD=iCAD
ICCC=伊芙美尔医疗
ICCH=ICC Holdings
ICGA=ICG Hypersonic
IDBA=IDEX Biometrics
IDEX=Ideanomics
IDRA=井寺制药
IEA=基础设施和能源替代
IFBD=讯鸟软件
IFMK=iFresh
IGAC=Ig Acquisition
IGIC=Tiberius Acquisition
IGNY=Ignyte Acquisition
IIII=Insu
IINN=Inspira Technologies
IKNX=Ikonics
IKT=Inhibikase
ILAC=Innovatus Life
ILAG=Intelligent Living
ILS=Insurance Income
ILSAP=Insurance Income优先
IMAC=IMAC Holdings
IMAQ=International
IMBI=iMedia Brands
IMCC=IM Cannabis
IMNM=Immunome
IMRN=Immuron
IMTE=综合媒体科技
IMTX=Immatics
IMV=IMV
IMVT=Immunovant
IMXI=国际货币快递
INKA=KludeIn I
INM=InMed
INMB=INmune Bio
INNV-2=Innovus制药
INPX=Inpixon
INSE=Inspired
INTG=The Intergroup
INTZ=Intrusion
INVE=单片机微系统
INVO=INVO Bioscience
INVZ=Innoviz Technologies
IPA=Immunoprecise
IPAX=Inflection Point
IPDN=专业多样网络
IPVI=InterPrivate IV
IPW=iPower
IPWR=Ideal Power
IRMD=Iradimed
IROQ=IF Bancorp
ISAA=Iron Spark I
ISCO-1=国际干细胞
ISGN-1=Isign Solutions
ISIG=徽章系统
ISLE=Isleworth
ISNS=图像传感系统
ISPC=iSpecimen
ISUN=iSun
ITAC=Industrial Tech
ITAQ=Industrial Tech
ITHX=ITHAX Acquisition
ITI=Iteris
ITMR=Itamar Medical
ITQ=Itiquira收购
IVCP=Swiftmerge
IZEA=IZEA
JAAC=Just Another
JACA=Jeneration
JAGX=Jaguar Health
JAN=JanOne
JAQC=Jupiter
JCIC=Jack Creek
JCTCF=朱伊特卡梅伦贸易
JMPW=跳跃网络
JOFF=JOFF Fintech
JRSH=Jerash Holdings
JUGG=Jaws Juggernaut
JUPW=Jupiter Wellness
JVA=Coffee控股
JWEL=聚好商城
JWIZ=JWiz
JYAC=Jiya
JYNT=The Joint
JZXN=九紫新能
KAII=Kismet Acquisition
KAIR=Kairos Acquisition
KBLB=Kraig Biocraft
KBNT=Kubient
KBSF=KBS服饰集团
KERN=Akerna
KETA=Keter1 Acquisition
KIII=Kismet Acquisition
KIN=Kindred Biosciences
KINS=金石保险
KINZ=Kins Technology
KLAQ=KL Acquisition
KMPH=KemPharm
KOR=Corvus Gold
KOSS=高斯电子
KRBP=Kiromic BioPharma
KRMD=Repro Med Systems
KRNL=Kernel Group
KRYS=Krystal Biotech
KSI=Kadem Sustainable
KSMT=Kismet Acquisition
KSPN=Kaspien
KTRA=Kintara
KTTA=Pasithea
KURI=Alkuri Global
KVSA=Khosla Ventures
KVSB=Khosla Ventures
KVSC=Khosla Ventures
KVSD=Khosla Ventures
KXIN=开心汽车
KZIA=Kazia Therapeutics
LAAA=Lakeshore
LACQ=Leisure Acquisition
LATN=Union Acquisition
LAZR=Luminar Technologies
LAZY=Lazydays Holdings
LCA=Landcadia Holdings
LCAA=L Catterton Asia
LCAP=Lionheart
LCNB=LCNB
LCP=LCP Acquisition
LCY=Landcadia
LDHA=LDH Growth
LE=Lands'End
LEDS=旭明光电
LEGA=Lead Edge Growth
LEGN-1=Legion Capital
LEGO=Legato
LEXX=Lexaria Bioscience
LFMD=LifeMD
LFTA=Lazard Fintech
LFTR=Lefteris
LFVN=Lifevantage
LGAC=Lazard Growth
LGHL=狮子集团控股
LGHLP=狮子集团优先
LGVN=Longeveron
LHAA=Lerer Hippeau
LHCA=Lazard Healthcare
LHIV=Lionheart IV
LHRT=Lionheart III
LIND=Lindblad
LINK=互联电子
LIQT=Liqtech国际
LITT=Logistics
LIVE=Live Ventures
LIVK=LIV Capital
LIVX=LiveXLive Media
LIXT=Lixte Biotechnology
LJAQ=LightJump
LJPC=La Jolla制药
LKCO=箩筐技术
LLIT=联络智能
LMACA=Liberty Media
LMAO=LMF Acquisition
LMB=Limbach Holdings
LMFA=Lm Funding America
LMPX=LMP Automotive
LMST=Limestone合众银行
LNSR=Lensar
LOAN=曼哈顿大桥投资股份
LOHA=乐活
LPC=Lamar Partnering
LPCN=Lipocine
LPTH=光路技术
LQDA=Liquidia
LRIS=Laris Media
LSAQ=Lifesci
LSEA=Landsea Homes
LTBR=Lightbridge
LTRN=Lantern Pharma
LTRX=创力
LUNA=Luna创新
LUNG-1=Prolung
LUXA=Lux Health
LVRA=Levere Holdings
LWAC=Locust Walk
LYL=龙运国际
LYT=Lytus Technologies
M00264=细胞动力科技优先
M01207=Todos Medical
M01219=嘉纳科技
M01243=Cojax
M01259=Engage BDR
M01280=Bannix Acquisition
M01281=Grom Social
M01285=INSU Acquisition
M01288=Blueprint Health
M01297=Vector Acquisition
M01299=Vector Acquisition
M01303=Falcon Capital
M01305=Patria Acquisition
M01307=Good Commerce
M01311=Snow Lake Resources
M01316=Crescera Capital
M01318=Focus Impact
MAAC=Montes Archimedes
MACA=Moringa
MACQ=MCAP Acquisition
MACU=Mallard
MAQC=Maquia Capital
MARA=Marathon Digital
MARK=Remark控股
MARPS=海洋石油信托
MAYS=梅斯物业
MBCN=Middlefield Banc
MBII=马罗尼生物创新
MBIN=Merchants
MBINP=Merchants优先A
MBOT=Microbot Medical
MBRX=Moleculin Biotech
MBTC=Nocturne
MCAD=Mountain Crest
MCMJ=Merida Merger
MCTY=Motor City
MDGL=新泰医药
MDGS=Medigus
MDIA=MediaCo Holding
MDJH=明大嘉和
MDNA=Medicenna
MDRR=Medalist Diversified
MDRRP=Medalist 优先 A
MDVL=MedAvail Holdings
MDWT=Midwest
MDXG=Mimedx Group
MEAC=Mercury Ecommerce
MEDS=Trxade Group
MEIP=美制药
METX=美联国际教育
MFH=Mercurity Fintech
MFNC=麦基诺金融
MICT=MICT
MILE=Metromile
MITA=Coliseum
MITC=MeaTech 3D
MITK=Mitek系统
MKD=摩贝
MKGI=Monaker Group
MKTY=Mechanical
MLAC=Malacca Straits
MLND=Millendo疗法
MMAC=MMA投资控股
MNPR=Monopar Therapeutics
MNSB=MainStreet Bank
MNTK=Montauk Renewables
MNTX=摩尼综合机械
MOGO=Mogo
MON=Monument Circle
MOOS=Moose Pond
MOSY=正一科技
MOTN=Motion
MOTS=Motus Gi控股
MOVE=Movano
MOXC=魔线
MPAC=Model Performance
MRAC=Marquee Raine
MRKR=Marker Therapeutics
MRM=MEDIROM Healthcare
MRMR=Mr2 Group
MRTX=Mirati Therapeutics
MSAC=Medicus Sciences
MSDA=MSD Acquisition
MSGM=Motorsport Games
MSRT-1=MassRoots
MSVB=Mid-Southern Bancorp
MTAC=MedTech
MTBC=CareCloud
MTBCP=CareCloud优先A
MTC=海川证券
MTEM=Molecular Templates
MTP=Midatech Pharma
MTSL=Mer Telemanagement
MUDS=Mudrick
MULG=牧粮实业
MVBF=MVB Financial
MWK=Mohawk Group
MYMD=MyMD Pharmaceuticals
MYSZ=My Size
MYT=茗韵堂
NAAC=North Atlantic
NAKD=Naked Brand Group
NAOV=NanoVibronix
NATR=天然阳光产品
NBCP=Nb资本收购
NBEV=NewAge
NBSE=NeuBase疗法
NBST=Newbury Street
NCAC=Newcourt
NCBS=Nicolet Bankshares
NCTY=第九城市
NDAC=NightDragon
NDRA=Endra Life Sciences
NEBC=Nebula Caravel
NECB=NorthEast Community
NEO=Neogenomics
NEON=Neonode
NEPH=Nephros
NEPT=海王星科技
NESR=国家能源服务
NETE=网元
NEWA=烟台金正环保
NEXT=NextDecade
NGAC=Nextgen
NGCA=NextGen
NGIO=Nugenerex
NGIOP=Nugenerex
NHIC=Newhold Investment
NHLD=NewHold Investment
NHTC=然健环球
NISN=宁圣国际
NKLA=Nikola
NKSH=国家银行
NLSP=NLS Pharmaceutics
NMMC=North Mountain
NMRD=Nemaura Medical
NMTR=9 Meters
NNDM=Nano Dimension
NOAC=Natural Order
NODK=NI Holdings
NOTV=Inotiv
NPAB=New Providence
NPAC=New Providence
NPS=北方电力
NRAC=Noble Rock
NSAL=Navios South
NSYS=诺泰克电子
NTEC=Intec Pharma
NTRB=Nutriband
NTWK=奈特阳科技
NUGN=Nugene International
NURO=神经矩阵医疗
NUWE=CHF Solutions
NUZE=NuZee
NVCN=Neovasc
NVEC=NVE科技
NVEE=NV5 Global
NVOS=Novo Integrated
NVSA=New Vista
NVVE=Nuvve Holding
NXMD=Nexeon Medsystems
NXTD=Nxt-ID
NYMX=耐莫斯制药
OACA=Ocelot Acquisition
OBCI=海洋生化
OBLG=Oblong
OCAX=OCA Acquisition
OCCI=OFS Credit
OCDX=Ortho Clinical
OCG=东方文化
OCGN=Ocugen
OCUP=Ocuphire Pharma
ODAC=Ocean Drive
OEG=Orbital Energy
OEPW=One Equity Partners
OESX=猎户能源系统
OFED=Oconee联邦金融
OHPA=Orion Acquisition
OLB=The OLB Group
OMEG=Omega Alpha
OMEX=奥德赛海洋探索
ONCS=OncoSec医疗
ONCT=Oncternal医疗
ONCY=溶瘤生物科技
ONDS=Ondas Holdings
ONTX=Onconova医疗
OPGN=OpGen
OPHC=合宜银行控股
OPNT=Opiant制药
OPOF=Old Point金融
OPRX=Optimizerx
OPTT=海洋动力科技
ORGO=Organogenesis
ORGS=Orgenesis
ORIA=Orion Biotech
ORMP=Oramed制药
ORRF=奥斯城金融服务
OSAA=OS Acquisition
OSN=奥盛创新
OSPN=OneSpan
OSS=One Stop Systems
OST=奥斯汀科技
OSTR=Oyster Enterprises
OSW=Onespaworld控股
OTEC=OceanTech
OTRA=Otr Acquisition
OTRK=Ontrak
OUTR=Space Acquisition
OVLY=橡木谷银行
OXBR=Oxbridge Re
PACV-1=Pacific Ventures
PACX=Pioneer Merger
PAE=PAE
PAIC=Petra Acquisition
PANA=Panacea Acquisition
PANL=盘古物流解决方案
PAQC=Provident
PAVM=PAVmed
PAYA=Paya Holdings
PAYS=Paysign
PBBK=PB Bankshares
PBFS=Pioneer Bancorp
PBHC=探路者合众银行
PBLA=Panbela Therapeutics
PBTS=宏桥高科
PCCT=Perception Capital
PCIM=Pci Media
PCOM=Points国际
PCSA=Processa
PCSB=PCSB Financial
PCT=PureCycle
PCYG=Park City Group
PCYO=Pure Cycle
PDEX=Pro-Dex
PEGR=Project Energy
PESI=佩尔马福克斯环境服务
PETV=Petvivo
PETZ=青岛天地荟食品
PFDR=Pathfinder
PFIE=Profire Energy
PFSW=PFS网络
PGRW=Progress
PHCF=普惠财富
PHIC=Population Health
PHIO=Phio Pharmaceuticals
PHUN=Phunware
PIRS=Pieris制药
PIXY=Shiftpixy
PKBK=帕克合众银行
PLBC=普卢默斯合众银行
PLBY=PLBY Group
PLIN=香态食品
PLL=Piedmont Lithium
PLMI=Plum Acquisition
PLSE=脉冲生物科学
PLUG=普拉格能源
PLXP=PLx Pharma
PMD=Psychemedics
PME=平潭海洋
PMGM=Priveterra
PMV=PMV Acquisition
PNRG=PrimeEnergy
POAI=Predictive Oncology
POGO=PogoTec
POLA=Polar Power
POW=Powered
POWW=Ammo
PPBT=Purple Biotech
PPGH=Poema Global
PPSI=先驱电气
PPTA=Perpetua Resources
PRCH=Porch Group
PRFX=PainReform
PROF=Profound Medical
PRPH=ProPhase实验室
PRPL=紫色创新
PRPO=Precipio
PRSR=Prospector Capital
PRTG=Portage Biotech
PRTH=Priority Technology
PRTX=Protalex
PRVB=Provention Bio
PSAC=Property Solutions
PSAG=Property Solutions
PSHG=Performance Shipping
PSIT=PSI国际
PSTI=Pluristem疗法
PSTV=Plus Therapeutics
PSYC=Telemynd
PTE=PolarityTE
PTIC=Proptech
PTOC=Pine Technology
PTPI=Petros
PTRS=Partners
PUCK=Goal Acquisitions
PVBC=Provident Bancorp
PXMD=PaxMedica
PXS=Pyxis Tankers
PYR=PyroGenesis Canada
QCEL=Q Therapeutics
QELL=Qell
QLGN=Qualigen治疗
QNZL=Quinzel
QPAA=Quiet Plus I
QQCY=青青草元
QRHC=Quest Resource控股
QTRN-1=Quintiles
QUES=Quest Solution
QWNB=Queen's Gambit
RAAC=Revolution
RACA=Therapeutics
RACB=Research Alliance
RADA=拉达电子工业
RADD=Corner Growth
RAII=Revolution
RAM=Aries I
RAND=兰德资本
RAVE=狂欢餐饮集团
RBCN=卢比肯科技
RBKB=Rhinebeck Bancorp
RBNC=Reliant Bancorp
RCAT=Red Cat Holdings
RCDA=Red Cell DRM
RCEL=AVITA Medical
RCHG=Recharge
RCLF=Rosecliff
RCM=R1 RCM
RCON=研控科技
RCPI=Reverence
RCRT=Recruiter.com
RDCM=RADCOM
RDHL=Redhill Biopharma
RDI=全球阅读A
RDIB=全球阅读B
RDVT=Red Violet
REE=REE Automotive
REED=Reeds饮料
REFR=前沿研究
REKR=Rekor Systems
RELI=Reliance
REPH=Recro制药
RESN=Resonant
RETO=瑞图生态
REVH=Revolution
RGAC=Rocket Global
RGCB=Regencell Bioscience
RIBT=米糠科技
RICO=Agrico Acquisition
RIOT=Riot Blockchain
RKDA=阿凯迪亚生物科学
RLMD=Relmada治疗
RLTY=Royalty Flow
RMBI=Richmond互助银行
RMBL=Rumbleon
RMGB=RMG Acquisition
RMGC=RMG Acquisition
RMGD=RMG Acquisition
RMGE=RMG Acquisition
RMGF=RMG Acquisition
RMGG=RMG Acquisition
RMR=The RMR Group
RNAZ=TransCode
ROCC=Roth CH Acquisition
ROCR=Roth CH
RPAY=Repay控股
RSAS=Resaas服务
RSSS=Research Solutions
RSVA=Rodgers Silicon
RTPY=Reinvent Technology
RVAC=Riverview
RVPH=Reviva
RWLK=ReWalk Robotics
RXRA=RXR Acquisition
RZLT=Rezolute
SAII=Software Acquisition
SAL=Salisbury银行
SAMA=Schultze Special
SANW=S&W Seed
SAVA=Cassava Sciences
SBEA=SilverBox Engaged
SBFG=SB金融
SBT=Sterling Bancorp
SCAQ=Stratim Cloud
SCIB=Science Strategic
SCIC=Science Strategic
SCIT=三彩家
SCKT=SOCKET移动
SCLE=Broadscale
SCOA=ScION Tech Growth
SCOB=ScION Tech Growth
SCYB=Scythian Biosciences
SDAC=Sustainable
SDH=师董会
SEEL=Seelos Therapeutics
SELF=Global Self Storage
SEPG=SEP Growth
SFBC=Sound Financial银行
SFET=Safe-T Group
SFT=Shift Technologies
SGAM=Seaport Global
SGBX=SG Blocks
SGLB=Sigma Labs
SGMA=喜玛庆国际
SGOC=上为
SGRP=SPAR商业服务集团
SHAC=Scp & Co
SHCA=Spindletop Health
SHIP=Seanergy海事控股
SHQA=Shelter
SHSP=SharpSpring
SIC=Select Interior概念
SIEB=西伯特金融
SIER=Sierra Lake
SIFY=思飞科技
SINO=中环球船务
SINT=SINTX Technologies
SJ=思享无限
SKYA=Skydeck
SKYT=SkyWater Technology
SLAM=Slam
SLCR=Silver Crest
SLGG=Super League Gaming
SLN=Silence Therapeutics
SLNO=Soleno Therapeutics
SLP=Simulations Plus
SLS=SELLAS生命科学
SLVR=SilverSPAC
SMBK=Smartfinancial
SMED=Sharps Compliance
SMID=Smith-Midland
SMIT=施密特工业
SMMF=萨米特银行
SMPL=Simply Good Foods
SMSI=史密斯微软件
SMTI=Sanara
SNCA=Seneca Biopharma
SNES=SenesTech
SNGX=Soligenix
SNOA=Sonoma制药
SNRH=Senior Connect
SNTG=Sentage控股
SOLE=唯一精英集团
SOLO=Electrameccanica汽车
SOLY=Soliton
SONN=Sonnet
SPCB=Supercom
SPGL=SPGL Acquisition
SPK=SPK Acquisition
SPKB=Silver Spike
SPRT=在线赞助
SPT=Sprout Social
SPTK=SportsTek
SQBG=Sequential Brands
SQFT=Presidio Property
SQL=SeqLL
SQL-1=SeqLL
SRAX=SRAX
SRNE=索伦托医疗
SRNG=Soaring Eagle
SRSA=Sarissa
SRTN=Spartan
SRTS=申舒斯医疗保健
SSAA=Science Strategic
SSKN=STRATA Skin Sciences
SSNT=Silversun
SSPK=Silver Spike收购
SSSS=SuRo Capital
SSTI=Shotspotter
STAF=Staffing 360
STKS=The One
STLRA=Stellaris Growth
STND=Standard AVB金融
STRM=流线保健
STWO=Acon S2
SUMR=夏婴
SUNW=Sunworks
SV=Spring Valley
SVAC=Starboard Value
SVBI=塞弗恩银行
SVFA=SVF Investment
SVFB=SVF Investment
SVFC=SVF Investment
SVFD=Save Foods
SVII=Spring Valley
SVOK=Seven Oaks
SWAG=Software
SWET=Athlon Acquisition
SWGC=Stillwater Growth
SWKH=SWK Holdings
SWSS=Springwater
SXTC=苏轩堂
SYBX=Synlogic
SYTA=Siyata Mobile
SZZL=Sizzle Acquisition
TACC=Tahawi Aerospace
TACO=Del Taco Restaurants
TACQ=Tetragon
TAIT=Taitron电子配件
TALS=Talaris Therapeutics
TANH=碳博士控股
TAOP=淘屏
TARA=Protara治疗
TAYD=泰勒设备
TBCP=Thunder Bridge
TBLD=Thornburg Income
TBLT=ToughBuilt工业
TBSA=TB SA Acquisition
TC=团车
TCAC=Tuatara Capital
TCBC=TC Bancshares
TCBS=Texas Community
TCFC=社区金融
TCG=TCG Growth
TCPG=Transformational
TCVA=TCV Acquisition
TCX=Tucows
TDAC=Trident
TEGA=Think Elevation
TEKC=Tekkorp Digital
TEKK=Tekkorp
TELL=Tellurian
TENX=Tenax Therapeutics
TETC=Tech and Energy
TFFP=TFF Pharmaceuticals
TGAA=Target Global
TGLS=Tecnoglass
TGTX=TG治疗
TH=Target Hospitality
THBR=Thunder Bridge
THCA=Tuscan Holdings
THCB=Tuscan控股
THCP=Thunder Bridge
THMA=Thimble Point
THMO=ThermoGenesis
THRY=Thryv Holdings
THTX=Theratechnologies
TIOA=Tio Tech A
TIPT=Tiptree
TIRX=天睿祥
TLMD=SOC Telemed
TMDI=Titan Medical
TMKR=Tastemaker
TMPM=Turmeric
TMTS=Spartacus
TOMZ=TOMI环境
TONY=淘你欢
TOPS=Top Ships
TPBA=TPB Acquisition
TRCH=炬光能源
TRIL=延龄草治疗
TRKA=Troika Media Group
TRMT=Tremont Mortgage
TRON=Corner Growth
TSIA=Ts Innovation
TSIB=Tishman Speyer
TSRI=TSR软件
TTCF=Tattooed Chef
TTNP=Titan制药
TUGC=TradeUP Global
TVAC=Thayer Ventures
TWCB=Bilander
TWCG=Galliot
TWCM=Mistico
TWCT=Twc Tech
TWER=塔流通信
TWLV=Twelve Seas
TWNK=Hostess Brands
TXC=Teraphysics
TYHT=尚高
TYME=Tyme科技
TZPS=TZP Strategies
UBCP=联合合众银行
UFIN=Ufin Tek
UFPT=UFP技术
UGRO=Urban-gro
UIHC=United Insurance控股
UK=优客工场
UMB=Umbra Technologies
UNOO=1Sharpe
UONE=Urban One
UONEK=Urban OneD类普通
UPTD=TradeUP
UROY=Uranium Royalty
USAU=U.S. Gold
USCR=U.S. Concrete
USEG=美国能源
USIO=Usio
USWS=U.S. Well Services
UTME=联代科技
UTXOA=UTXO Acquisition
VABK=Virginia National
VACI=Victory
VACQ=Vector
VALU=Value Line
VAQC=Vector Acquisition
VBFC=农村金融信托银行
VBIV=VBI Vaccines
VCEL=Vericel
VCKA=Vickers Vantage
VCVC=10x Capital
VCXA=10X Capital
VEEE=Twin Vee PowerCats
VELO=Velocity
VEMC=Velocity Merger
VENA=Venus Acquisition
VERB=Verb Technology
VERU=Veru
VERY=Vericity
VFF=Village Farms国际
VIEW=View
VIH=Vpc Impact
VIHB=VPC Impact
VII=7GC & Co. Holdings
VINC=Vincerx Pharma
VINO=Gaucho Group
VIOT=云米
VIRI=Virios
VISL=Vislink技术
VITL=Vital Farms
VIVE=Viveve Medical
VIVK=Vivakor
VJET=维捷
VKTX=Viking Therapeutics
VLAT=Valor Latitude
VLON=Vallon
VMAC=Vistas Media
VMAR=Vision Marine
VMD=Viemed Healthcare
VOSO=Virtuoso
VPCB=VPC Impact
VRAR=The Glimpse Group
VRDN=Viridian
VRME=Verifyme
VRPX=Virpax
VRRM=Verra Mobility
VS=Versus Systems
VSPR=Vesper Healthcare
VTAQ=Ventoux CCM
VTGN=Vistagen
VTIQ=VectoIQ Acquisition
VTNR=顶点能源
VTSI=VirTra
VUZI=Vuzix
VVOS=Vivos
VVPR=VivoPower
VXRT=Vaxart
VYNT=Vyant Bio
WAFU=华富教育
WALD=Waldencast
WALL=金城国际
WATT=Energous
WCAT=Jaws Wildcat
WCOR=World Technology
WCRT=西海岸房地产信托
WETG=悦商集团
WFCF=Where Food Comes
WFRD=威德福国际
WHLM=Wilhelmina国际
WHLR=Wheeler房产投资信托
WHLRD=Wheeler房产优先D
WHLRP=Wheeler房产优先B
WHSM=Whitesmoke, Inc.
WILC=G. Will食品国际
WINT=Windtree
WISA=Summit无线技术
WIZD-1=Wizard Brands
WKHS=Workhorse集团
WMPN=William Penn
WNW=物农网
WORX=SCWorx
WRAP=Wrap技术
WSC=WillScot Mobile
WTER=The Alkaline Water
WTRH=Waitr Holdings
WVVI=维拉美特酒庄
WVVIP=维拉美特酒庄优先
XAIR=Beyond Air
XBIO=Xenetic Biosciences
XCUR=Exicure
XELA=Exela Technologies
XPDI=Power & Digital
XPEL=XPEL
XSPA=XpresSpa Group
XTLB=Xtl生物制药
YGMZ=盐港明珠
YMTX=Yumanity
YSAC=Yellowstone
YTEN=Yield10 Bioscience
YTRA=Yatra Online
YVR=Liquid Media
YZCM=越众文化传媒
ZCMD=众巢医学
ZENV=Zenvia
ZGHB=中国环保新材集团
ZGYH=运鸿国际
ZING=FTAC Zeus
ZIOP=ZIOPHARM肿瘤
ZIVO=Zivo Bioscience
ZKIN=正康国际
ZNTE=Zanite
ZSAN=Zosano Pharma
ZT=Zimmer Energy
ZWRK=Z-Work Acquisition
ZYXI=Zynex
[name_184_187]
ConfigVer=20210427_0
[name_184_188]
ConfigVer=20210427_0
[name_184_189]
ConfigVer=20210427_0
[name_184_190]
ConfigVer=20210427_0
