[name_168_168]
ConfigVer=20210303_0
[name_168_169]
ConfigVer=20210303_1512359315
A=安捷伦科技
AA=美国铝业
AAA=第一优先级CLO债券ETF
AAAU=黄金现货ETF
AAC=Ares Acquisition
AADR=多尔西赖特ADR ETF
AAIC=阿灵顿资产投资
AAICpB=阿灵顿资产优先B
AAICpC=阿灵顿资产优先C
AAN=The Aaron
AAP=领先汽车配件
AAQC=Accelerate
AAT=美国资产信托
AB=联博控股
ABB=阿西布朗勃法瑞
ABBV=艾伯维
ABC=美源伯根
ABEQ=绝对核心策略ETF
ABEV=安贝夫啤酒
ABG=阿斯伯里汽车集团
ABM=ABM工业
ABR=阿伯房地产信托
ABRpA=阿伯房地产信托优先A
ABRpB=阿伯房地产信托优先B
ABRpC=阿伯房地产信托优先C
ABT=雅培
AC=Associated Capital
ACA=Arcosa
ACB=Aurora Cannabis
ACC=美国校园REITs
ACCC=Atlas Crest
ACCO=ACCO Brands
ACCV=Atlas Crest
ACEL=Accel Entertainment
ACH=中国铝业
ACI=艾伯森
ACIC=Atlas Crest
ACII=Atlas Crest
ACIV=Atlas Crest
ACM=AECOM
ACN=埃森哲
ACND=Ascendant Digital
ACR=ACRES Commercial
ACRE=阿瑞斯商业地产
ACSG=ESG领导者指数ETF
ACTV=LeaderShares活跃领袖
ACVF=美国保守价值ETF
ACWF=ACWI多元多因素指数
ACWV=最小波动率指数ETF
ADC=艾格里不动产
ADCT=ADC Therapeutics
ADEX=Adit EdTech
ADF=Aldel Financial
ADM=阿彻丹尼尔斯米德兰
ADNT=Adient
ADS=联合数据系统
ADT=ADT
AEE=阿曼瑞恩
AEG=荷兰全球保险
AEL=美国股票投资寿险
AEM=伊格尔矿业
AENZ=Aenza
AEO=美国鹰
AER=Aercap飞机租赁
AES=爱依斯电力
AFG=美国金融
AFGL=AFG Holdings
AFI=阿姆斯特朗地板
AFK=MVIS GDP非洲指数ETF
AFL=美国家庭人寿保险
AFLG=活跃因子大型股ETF
AFMC=活跃因子中盘ETF
AFN=Affinia集团控股
AFSM=活跃因子小型股ETF
AFTY=中国A50净回报指数ETF
AG=First Majestic银矿
AGAC=African Gold
AGCB=Altimeter Growth
AGCO=爱科集团
AGG=美国综合债券指数ETF
AGGY=美国综合收益指数ETF
AGI=Alamos Gold
AGM=联邦农业抵押贷款C
AGM.A=联邦农业抵押A
AGMpD=联邦农业抵押优先D
AGO=保证担保
AGQ=白银分类指数两倍做多
AGR=Avangrid
AGRO=Adecoagro
AGS=PlayAGS
AGX=Argan
AGZ=美国代理指数ETF
AHC=AH贝罗
AHH=Armada Hoffler
AHHpA=Armada Hoffler优先A
AHLpC=阿斯彭保险C类优先
AHLpD=阿斯彭保险D类优先
AHM=Amerihome
AHT=阿什福德酒店管理信托
AHTpD=阿什福德信托D类优先
AHTpF=阿什福德信托F类优先
AHTpG=阿什福德信托G类优先
AHTpH=阿什福德信托H类优先
AHTpI=阿什福德信托I类优先
AI=C3.ai
AIEQ=人工智能驱动股票ETF
AIG=美国国际集团
AIGpA=美国国际集团优先A
AIIQ=AI动力国际股票ETF
AIN=奥尔巴尼国际
AIO=AllianzGI AIO Fund
AIR=AAR
AIRC=Apartment Income
AIT=应用工业技术
AIV=公寓投资管理
AIZ=艾斯兰
AIZP=艾斯兰优先
AJAX=Ajax
AJG=亚瑟加拉格尔
AJRD=Aerojet Rocketdyne
AJX=Great Ajax
AKO.A=Andina饮料A
AKO.B=Andina饮料B
AKR=阿卡迪亚不动产信托
AL=航空租赁
ALB=雅宝
ALC=爱尔康
ALE=阿里特
ALEX=亚历山大&鲍德温
ALFA=对冲基金大师指数ETF
ALG=阿拉莫
ALK=阿拉斯加航空
ALL=好事达保险
ALLE=Allegion Public
ALLY=Ally金融
ALON=安良科技
ALPpQ=Alabama电力优先Q
ALSN=艾里逊变速箱
ALTG=Alta Equipment
ALTL=美大盘股轮换指数ETF
ALUS=Alussa Energy
ALV=奥托立夫
ALX=亚历山大
ALpA=航空租赁优先A
AM=Antero Midstream
AMBC=Ambac Financial
AMC=AMC院线
AMCR=Amcor
AME=阿美特克
AMG=AMG资管
AMH=American Homes 4
AMHpD=美国家庭 4 Rent优先D
AMHpE=美国家庭 4 Rent优先E
AMHpF=美国家庭 4 Rent优先F
AMHpG=美国家庭 4 Rent优先G
AMHpH=美国家庭 4 Rent优先H
AMJ=MLP指数ETF
AMK=AssetMark金融控股
AMLP=MLP基础设施指数ETF
AMN=AMN医疗服务
AMNA=中游能源选择指数ETF
AMND=中游能源股息指数ETF
AMOM=美国大盘股动量ETF
AMOV=美洲移动普通存托A
AMP=阿默普莱斯金融
AMPI=Advanced Merger
AMPY=Amplify Energy
AMR=Alpha Metallurgical
AMRC=阿梅雷斯克
AMRX=Amneal制药
AMT=美国电塔
AMTR=中游能源指数ETF
AMUB=MLP指数ETF
AMWL=American Well
AMX=美洲移动
AMZA=活跃MLP ETF
AN=全美汽车租赁
ANAC=Arctos NorthStar
ANET=Arista Networks
ANEW=MSCI转型变化ETF
ANF=阿贝克隆比 & 费奇
ANGL=美高收益约束指数ETF
ANH=安沃思抵押
ANHpA=安沃思A类优先
ANHpB=安沃思B类优先
ANHpC=安沃思C类优先
ANTM=Anthem
AOA=目标风险激进指数ETF
AOK=目标风险保守指数ETF
AOM=目标风险中度指数ETF
AON=怡安
AONE=One
AOR=目标风险增长指数ETF
AOS=A.O.史密斯
AP=安博科-匹兹堡
APAM=Artisan合伙资产管理
APD=空气化工
APG=APi Group
APGB=Apollo Strategic
APH=安诺电子
APLE=Apple Hospitality
APO=阿波罗全球管理
APOpA=阿波罗全球管理优先A
APRN=Blue Apron Holdings
APSG=Apollo Strategic
APTS=优选公寓社区
APTV=安波福
AQN=Algonquin Power
AQUA=Evoqua Water
AR=Antero资源
ARB=合并套利美元对冲ETF
ARC=美国图文
ARCH=Arch Resources
ARCO=Arcos Dorados
ARD=Ardagh Group
ARDT=Ardent健康伙伴
ARE=亚历山大房地产
ARES=Ares Management
ARESpA=Ares Management优先A
ARGO=阿尔戈国际
ARGT=阿根廷25/50指数ETF
ARI=阿波罗房地产金融
ARKF=ARK Fintech创新
ARKG=ARK基因组革命ETF
ARKK=Ark创新ETF
ARKQ=自主技术与机器人ETF
ARKW=ARK下一代互联网ETF
ARL=美国房地产投资
ARLO=Arlo Technologies
ARMK=爱玛客
ARMR=盔甲美国股票指数ETF
ARNC=Arconic
AROC=Archrock
ARR=Armour住宅房产
ARW=艾睿电子
ASA=Asa Gold
ASAI=Sendas Distribuidora
ASAN=Asana
ASAQ=Atlantic Avenue
ASB=Associated Banc
ASBpC=Associated Banc优先C
ASBpD=Associated Banc优先D
ASBpE=Associated Banc优先E
ASC=阿德莫尔海运
ASEA=东盟40指数ETF
ASGI=Aberdeen
ASGN=盎塞
ASH=亚什兰
ASHR=沪深300指数ETF
ASHS=沪深500指数ETF
ASHX=MSCI中国A国际指数
ASIX=AdvanSix
ASN=Archstone Inc.
ASPI=Aspire Real Estate
ASPL=Aspirational
ASPN=Aspen Aerogels
ASR=东南亚机场集团
ASX=日月光投控
ASZ=Austerlitz II
AT=大西洋电力
ATA=Americas Technology
ATAC=Altimar Acquisition
ATAQ=Altimar
ATC=Atotech
ATCO=Atlas
ATEN=A10 Networks
ATGE=Adtalem Global
ATH=Athene Holding
ATHM=汽车之家
ATHN=Athena Technology
ATHpA=Athene Holding优先A
ATI=阿勒格尼
ATKR=Atkore
ATMP=选择MLP指数ETF
ATMR=Altimar
ATO=ATMOS能源
ATR=阿普达集团
ATTO=Atento
ATUS=Altice USA
ATWO-1=two
AU=盎格鲁黄金
AUNA=Auna
AUS=Austerlitz I
AUSF=财富战略美国因素指数
AUY=亚马纳黄金
AVA=阿维斯塔
AVAL=Aval存优
AVAN=Avanti
AVB=艾芙隆海湾社区
AVD=美国先锋
AVDE=Avantis国际股票ETF
AVDV=国际小盘价值ETF
AVEM=新兴市场股票ETF
AVIG=Avantis核心固定收益
AVLR=Avalara
AVMU=核心市政固定收益ETF
AVNS=Avanos Medical
AVNT=Avient
AVRE=Avenue资本抵押房产
AVSF=Avantis短期固定收益
AVTR=Avantor
AVTRpA=Avantor优先A
AVUS=Avantis美国股票ETF
AVUV=美国小盘价值ETF
AVY=艾利丹尼森
AVYA=Avaya控股
AWAY=主要旅游技术指数ETF
AWI=阿姆斯特朗
AWK=美国水业
AWR=美洲国家水务
AWTM=超短期持续增强收益
AX=Axos Financial
AXL=美国车桥
AXP=美国运通
AXR=安美瑞普
AXS=埃克斯资本
AXSpE=埃克斯资本E类优先
AXTA=Axalta涂层系统
AYI=敏锐品牌
AYX=Alteryx
AZAA=大型股缓冲10 4月ETF
AZAJ=美国大盘股缓冲10一月
AZAL=大型股缓冲10 7月ETF
AZAO=美国大盘缓冲10十月
AZBA=大型股缓冲20 4月ETF
AZBJ=美国大盘股缓冲20一月
AZBL=大型股缓冲20 7月ETF
AZBO=美国大盘缓冲20十月
AZEK=AZEK
AZEK-1=CPG国际
AZO=汽车地带
AZRE=蔚蓝动力全球
AZUL=Azul
AZZ=AZZ
B=巴恩斯
BA=波音
BAB=建立美国债券指数ETF
BABA=阿里巴巴
BAC=美国银行
BACpA=美国银行EE类存托优先
BACpE=美国银行存托优先E
BACpK=美国银行优先K
BACpL=美国银行L类优先
BACpM=美国银行优先M
BAH=博思艾伦咨询
BAK=Braskem优先存托
BAL=棉花分项指数总回报
BALY=Bally
BAM=布鲁克菲尔德资产管理
BANC=加州银行
BANCpD=加州银行优先
BAP=Credicorp
BAR=黄金现货ETF
BATT=EQM锂电池技术指数ETF
BAX=百特国际
BB=黑莓
BBAR=Banco BBVA
BBC=生物技术临床试验指数
BBD=布拉德斯科银行优先
BBDC=Barings BDC
BBDO=布拉德斯科银行
BBL=必和必拓集团
BBMC=目标市场曝光扩展ETF
BBP=生物技术产品指数
BBSC=美小盘股目标市场风险
BBU=Brookfield Business
BBVA=Bank Bilbao Vizcaya
BBW=Build-A-Bear
BBY=百思买
BC=布朗斯威克
BCAT=BlackRock
BCC=Boise Cascade
BCD=商品长期K-1自由策略
BCE=加拿大贝尔
BCEI=富矿溪能源
BCH=智利银行
BCI=所有商品策略K-1免费
BCM=巴克莱商品指数ETF
BCO=布林克斯
BCS=巴克莱银行
BCSF=贝恩资本专业金融
BDC=百通
BDCX=公司指数1.5倍做多ETF
BDCZ=银行业务发展公司指数
BDN=布兰迪维因房地产信托
BDRY=干货运期货指数ETF
BDX=碧迪医疗
BE=Bloom Energy
BEDU=博实乐
BEKE=贝壳
BEN=富兰克林资源
BEP=布鲁克菲尔德可再生
BEPC=Brookfield Renewable
BERY=Berry Global Group
BEST=百世集团
BETZ=体育博彩游戏指数ETF
BF.A=布朗-福曼A
BF.B=布朗-福曼B
BFAM=Bright Horizons
BFLY=Butterfly Network
BFOR=Barron400指数ETF
BFS=索尔中心
BFSpD=索尔中心C类存托优先
BFT=Foley Trasimene
BFTR=贝莱德未来创新者ETF
BG=邦吉
BGS=B&G食品
BGSF=BGSF
BGSX=Build Acquisition
BH=Biglari控股
BH.A=Biglari控股A类
BHC=Bausch Health
BHE=基准电子
BHLB=伯克希尔山银行
BHP=必和必拓集团
BHR=Braemar酒店及度假村
BHRpB=阿什福德酒店优先B
BHRpD=阿什福德酒店优先D
BHVN=生物医药控股
BIBL=Inspire 100指数ETF
BIG=必乐透
BIL=1-3月美国国库券指数
BILL=Bill.com Holdings
BILS=3-12个月美国国库券
BIO=Bio Rad实验室A
BIO.B=Bio Rad实验室B
BIP=布鲁克菲尔德公共建设
BIPC=Brookfield
BITE=Bite Acquisition
BIV=美国政府信用浮动调整
BIZD=MVIS美国商业发展公司
BJ=BJ批发俱乐部控股
BJK=MVIS全球游戏指数ETF
BJS-1=BJ Services
BK=纽约梅隆银行
BKAG=美国综合债券指数ETF
BKD=布鲁克代尔高级护理
BKE=巴克尔
BKEM=新兴市场大盘指数ETF
BKF=国际金砖四国指数
BKH=黑山
BKHY=公司高收益指数ETF
BKI=巴克艾科技
BKIE=非美大盘股指数ETF
BKLC=美国大盘股指数ETF
BKLN=美国杠杆贷款指数ETF
BKMC=美国中型股指数ETF
BKR=Baker Hughes
BKSB=公司BBB 1-5年指数ETF
BKSE=美国小型股指数ETF
BKU=BankUnited
BLD=Topbuild
BLES=全球希望大盘均等体重
BLHY=动态信用ETF-Virtus
BLK=贝莱德
BLL=鲍尔包装
BLOK=转换数据共享ETF
BLV=长期政府信用浮动调整
BLX=拉丁美洲出口银行
BMA=Macro银行
BME=贝莱德健康科学信托
BMED=贝莱德未来健康ETF
BMI=Badger Meter
BMLpG=美国银行G类存托优先
BMLpH=美国银行存托优先H
BMLpJ=美国银行存托凭证优先
BMLpL=美国银行存托凭证优先
BMO=蒙特利尔银行
BMY=百时美施贵宝
BND=全球债券ETF
BNDC=核心选择债券基金
BNE=Blue Horizon BNE ETF
BNED=巴诺教育
BNKD=美国大银行3倍做空
BNKU=美国大银行指数做多
BNL=Broadstone
BNO=即月布伦特原油ETF
BNS=加拿大丰业银行
BOAC=Bluescape
BOAS=BOA Acquisition
BOH=夏威夷银行
BOIL=天然气指数两倍做多
BOND=PIMCO主动债券ETF
BOOT=Boot Barn
BORR=Borr Drilling
BOUT=IBD突破股票指数
BOX=Box
BP=英国石油
BPMP=BP Midstream
BPT=BPT信托
BQ=波奇宠物
BR=布罗德里奇
BR-1=Burlington Resources
BRBR=BellRing Brands
BRC=布雷迪
BRF=巴西小盘股指数ETF
BRFS=BRF
BRK.A=伯克希尔哈撒韦 A
BRK.B=伯克希尔哈撒韦 B
BRMK=Broadmark Realty资本
BRO=布朗保险经纪
BRT=BRT房地产信托
BRX=Brixmor Property
BRZU=巴西指数2倍做多ETF
BS-1=Bethlehem Steel
BSAC=桑坦德银行（智利）
BSAE=美元新兴市场债券
BSBE=新兴市场债券2022指数
BSBR=桑坦德银行(巴西)
BSCE=新兴市场债务2023指数
BSCL=公司债券2021年指数
BSCM=公司债券2022年指数
BSCN=公司债券2023指数ETF
BSCO=公司债券2024指数ETF
BSCP=公司债券2025指数ETF
BSCQ=公司债券2026指数ETF
BSCR=美元公司债券2027指数
BSCS=公司债券2028指数
BSDE=新兴市场债券2024
BSIG=BrightSphere投资
BSJL=高收益企业债券2021
BSJM=高收益企业债券2022
BSJN=高收益企业债券2023
BSJO=美元高收益公司债券
BSJP=高收益公司债券2025
BSJQ=高收益公司债券2026
BSM=Black Stone Minerals
BSMX=桑坦德银行墨西哥分行
BSN=Broadstone
BST=Blackrock Science
BSTZ=BlackRock STT信托II
BSV=1-5年政府/信贷浮动
BSX=波士顿科学
BTAL=美国中性反贝塔ETF
BTEK=贝莱德未来科技ETF
BTI=英美烟草
BTU=皮博迪能源
BTUpA=皮博迪能源优先A
BUD=百威英博
BUL=摇钱树生长指数ETF
BUR=伯福德资本
BURL=伯灵顿百货
BUZZ=矢量社会情绪ETF
BV=Brightview Holdings
BVH=Bluegreen Vacations
BVN=布埃纳文图拉开采
BW=布拉什
BWA=博格华纳
BWX=全球非美国资金指数
BWXT=BWX Technologies
BWZ=1-3年全球非美国国债
BX=黑石集团
BXC=布鲁林克斯
BXG=Bluegreen Vacations
BXMT=黑石抵押信托
BXP=波士顿地产
BXPpB=波士顿优先存托B类
BXS=BancorpSouth银行
BXT=美国比特币和财政投资
BY=Byline Bancorp
BYD=博伊德赌场
BYLD=债券收益率优化指数
BZH=贝哲房屋
BZQ=巴西25/50两倍做空
C=花旗
CAAP=Corporacion America
CABO=Cable One
CACI=CACI国际
CADE=Cadence
CAE=CAE
CAG=康尼格拉
CAH=卡地纳健康
CAHS=Colony American
CAI=CAI国际
CAIpB=CAI国际优先B
CAJ=佳能
CAL=Caleres鞋业
CALX=Calix
CANE=Teucrium糖基金ETF
CANG=灿谷
CAP=Capitol Investment
CAPE=美国核心行业指数ETF
CAPL=CrossAmerica
CARR=开利全球
CARS=Cars.com
CAS=Cascade Acquisition
CAT=卡特彼勒
CATO=加图商场
CB=安达保险
CBAH=CBRE Acquisition
CBB=辛辛那提贝尔
CBBpB=辛辛那提贝尔B类优先
CBD=巴西人零售存托优先
CBL=CBL金融
CBLS=资本多头/空头股票ETF
CBLpD=CBL金融D类存托优先
CBLpE=CBL金融E类存托优先
CBON=中国高质量债券指数
CBRE=世邦魏理仕
CBSE=资本可持续股票ETF
CBT=卡博特
CBU=社区银行系统
CBZ=CBIZ
CC=The Chemours
CCAC=中信资本收购
CCEP=可口可乐欧洲合伙
CCI=冠城国际
CCI-1=冠城国际
CCIV=Churchill Capital
CCJ=加拿大铀矿
CCK=皇冠控股
CCL=嘉年华邮轮
CCM=泰和诚医疗
CCO=清晰频道户外控股
CCON=互联消费指数ETF
CCOR=核心另类ETF
CCRV=商品曲线套利策略ETF
CCS=Century Communities
CCU=清晰频道
CCV=Churchill
CCVI=Churchill Capital
CCX=Churchill Capital
CDAY=Ceridian HCM Holding
CDE=科尔黛伦矿业
CDP=CDP集团
CDR=雪松房地产信托
CDRpC=雪松房地产信托优先C
CE=塞拉尼斯
CEA=东方航空
CEFD=基金指数1.5倍做多ETF
CEIX=CONSOL Energy
CELP=Cypress
CEN=CCB MLP & Energy基金
CEO=中国海洋石油
CEPU=Central Puerto
CEQP=Crestwood Equity
CEQPp=Crestwood Pref
CEW=新兴货币策略基金ETF
CF=CF实业
CFG=Citizens Financial
CFGpD=Citizens金融优先D
CFR=库伦佛寺银行
CFX=科尔法克斯
CGA=中国绿色农业
CGW=全球水资源指数ETF
CHA=中国电信
CHAA=Catcha Investment
CHAD=沪深300指数反向ETF
CHAQ=Chardan Healthcare
CHAU=沪深300指数两倍做多
CHCT=社区医疗保健信托
CHD=丘奇＆德怀特
CHE=Chemed
CHGG=Chegg
CHGX=更改多元化影响燃料
CHH=精选国际酒店
CHIE=中国能源指数ETF
CHIH=中国医疗保健指数ETF
CHII=中国工业10/50指数ETF
CHIK=信息技术10/50指数ETF
CHIL=中国50强选择指数ETF
CHIM=中国材料10/50指数ETF
CHIQ=消费者非必需品ETF
CHIR=房地产10/50指数ETF
CHIS=消费必需品指数ETF
CHIU=中国公用事业指数ETF
CHIX=中国金融10/50指数ETF
CHL=中国移动
CHMI=樱桃山抵押贷款投资
CHMIpA=樱桃山抵贷投资优先A
CHMIpB=樱桃山抵贷投资优先B
CHPT=ChargePoint
CHRA=Charah Solutions
CHS=Chico's FAS
CHT=中华电信
CHU=中国联通(香港)
CHWY=Chewy
CI=信诺保险
CIA=公民保险
CIB=哥伦比亚银行优先存托
CIEN=Ciena科技
CIG=Energy优先存托
CIG.C=Energy
CIM=奇美拉投资
CIMpA=奇美拉投资A类优先
CIMpB=奇美拉投资优先
CIMpD=奇美拉投资优先D
CINR=Ciner Resources
CIO=City Office Reit
CIOpA=City Office优先A
CIR=Circor国际
CIT=CIT Group
CIXX=Ci Financial
CK=Cke Inc.
CKH=海科控股
CL=高露洁
CLA=Colonnade
CLAA=Colonnade II
CLAS=Class Acceleration
CLB=核心实验室
CLDL=每日云计算多头2倍股
CLDR=Cloudera
CLDS=每日云计算空头2倍股
CLDT=Chatham Lodging信托
CLF=Cleveland-Cliffs
CLGX=CoreLogic
CLH=清洁海港
CLI=麦克凯利房地产
CLII=Climate Change
CLIM=Climate Real Impact
CLIX=长/短期在线商店指数
CLNC=Colony Northstar
CLNY=Colony Capital
CLNYpG=Colony 优先G
CLNYpH=Colony 优先H
CLNYpI=Colony 优先I
CLNYpJ=Colony 优先J
CLPR=Clipper Realty
CLR=大陆能源
CLS=天弘科技
CLTL=美国国债短期债券指数
CLVT=Clarivate
CLW=克利尔沃特纸业
CLX=高乐氏
CM=加拿大帝国商业银行
CMA=联信银行
CMBS=美国CMBS指数ETF
CMC=美国工商五金
CMCM=猎豹移动
CMD=Cantel Medical
CMDS=达闼科技
CMDY=滚动选择商品策略ETF
CMF=低税豁免市政债券指数
CMG=墨式烧烤
CMI=康明斯
CMO=卡帕史丹抵押
CMOpE=卡帕史丹抵押B类优先
CMP=罗盘矿物
CMRE=Costamare
CMREpB=Costamare B类优先
CMREpC=Costamare C类优先
CMREpD=Costamare D类优先
CMREpE=Costamare E类优先
CMS=CMS能源
CMSpB=CMS能源B类优先
CN=MSCI中国全股指数ETF
CNA=CNA金融
CNBS=西摩大麻ETF
CNC=康西哥
CND=Concord
CNF=泛华金融
CNHI=CNH Industrial
CNI=加拿大国家铁路
CNK=喜满客影城
CNMD=康美
CNNE=Cannae Holdings
CNO=康塞科
CNP=中点能源
CNPpB=中点能源B类优先
CNQ=加拿大自然资源
CNR=Cornerstone Building
CNRG=清洁能源指数ETF
CNS=科恩-斯蒂尔斯金融
CNX=CNX Resources
CNXT=中小企业创业板100
CO=中国脐带血库
CODI=罗盘多元化金融控股
CODIpA=罗盘多元化优先A
COE=51talk
COF=第一资本金融
COFpG=第一资本金融优先G
COFpH=第一资本金融优先H
COG=卡波特油气
COLD=Americold Realty
COM=赞助广泛商品策略ETF
COMB=彭博商品指数ETF
COMP=Compass
COO=库珀医疗
COP=康菲石油
COPX=全球铜矿商指数ETF
COR=科塞特不动产
CORN=玉米基金基准ETF
CORP=美林银行美国公司指数
CORR=CorEnergy
CORRpA=CorEnergy优先
COTY=科蒂
COW=家畜分类指数ETF
CP=加拿大太平洋铁路
CPA=科帕控股
CPAC=Pacasmayo水泥
CPB=康宝浓汤
CPE=卡隆石油
CPER=铜指数总回报ETF
CPF=中央太平洋银行
CPG=Crescent Point
CPI=IQ实际收益指数ETF
CPK=花旗K类优先
CPLG=CorePoint Lodging
CPNG=Coupang
CPRI=Capri Holdings
CPS=库珀标准控股
CPSR=Capstar
CPT=卡姆登物业信托
CPTK=Crown PropTech
CPUH=Compute Health
CQQQ=中国技术上限指数ETF
CR=Crane
CRAK=MVIS全球炼油厂指数
CRBN=MSCI ACWI低碳目标
CRC=加州资源
CRD.A=克劳福德A
CRD.B=克劳福德B
CRH=CRH水泥
CRHC=Cohn Robbins
CRI=卡特
CRK=康斯托克能源
CRL=查尔斯河
CRM=赛富时公司
CRN=Coronado Global
CROC=美元澳元汇率两倍做空
CRS=卡朋特科技
CRT=CRT信托
CRU=Crucible Acquisition
CRY=CryoLife
CS=瑞士信贷
CSD=美国分拆指数ETF
CSL=卡莱尔伙伴
CSLT=Castlight Health
CSPR=Casper Sleep
CSR=Centerspace
CSRpC=Centerspace优先C
CSTA=Constellation
CSTM=Constellium
CSU=品味生活资本
CSV=运输服务
CTAC=Cerberus Telecom
CTApA=杜邦A类优先
CTApB=杜邦B类优先
CTB=库珀轮胎与橡胶
CTK=触宝
CTLT=Catalent
CTO=CTO Realty Growth
CTS=CTS
CTT=Catchmark木材信托
CTVA=Corteva
CUB=立方
CUBE=CubeSmart
CUBI=客户合众银行
CUBIpC=客户合众优先C
CUBIpE=客户合众优先E
CUBIpF=客户合众优先F
CUK=嘉年华
CULP=卡尔普纺织
CURE=医疗保健每日三倍做多
CURO=Curo集团控股
CUT=木材精选上限指数ETF
CUZ=卡津斯不动产
CVA=卡万塔控股
CVE=Cenovus能源
CVEO=Civeo
CVI=CVR能源
CVII=Churchill Capital
CVNA=Carvana
CVS=西维斯
CVX=雪佛龙
CVY=多资产收益指数ETF
CW=寇蒂斯莱特
CWB=可换股债券指数ETF
CWEB=海外中国互联网指数
CWEN=Clearway Energy C
CWEN.A=Clearway Energy A
CWH=露营世界控股
CWI=ACWI除美国外指数ETF
CWK=Cushman & Wakefield
CWS=集中股权ETF
CWT=加州水务
CX=西麦斯
CXP=哥伦比亚房地产信托
CXW=CoreCivic
CYB=人民币策略基金ETF
CYD=玉柴国际
CYH=社区保健医院
CZA=中盘股核心指数ETF
CZZ=科桑
CpJ=花旗J类优先
D=道明尼能源
DAC=达那俄斯
DAL=达美航空
DAN=达纳
DAO=网易有道
DAR=美国达尔令国际
DASH=Doordash
DAVA=Endava
DB=德意志银行
DBA=DBIQ多元化农业指数
DBAW=除美国外美元对冲指数
DBB=最优工业金属指数回报
DBC=收益率多样化商品指数
DBD=迪堡金融设备
DBE=最优产能指数总回报
DBEF=EAFE 100%对冲美元ETF
DBEH=iM DBi对冲策略ETF
DBEM=EM美元对冲指数ETF
DBEU=欧洲美元对冲指数ETF
DBEZ=IMI美元对冲指数ETF
DBGR=德国100%对冲美元
DBI=DSW鞋类专卖
DBJP=日本100%对冲美元
DBLV=双线价值股票ETF
DBMF=iMDBi管理期货策略ETF
DBO=最佳产量原油指数回报
DBP=最优收益率贵金属指数
DBS=最佳收益白银指数
DBV=G10货币收获指数
DCI=唐纳森
DCO=杜科蒙
DCP=DCP Midstream
DCUE=道明尼能源优先
DD=陶氏杜邦
DDD=3D系统
DDF=特拉华州投资股息收益
DDG=石油与天然气指数做空
DDM=道琼斯指数两倍做多
DDS=狄乐百货
DE=迪尔
DEA=东风政府物业
DECK=戴克斯户外
DEED=TCW证券化加ETF
DEEF=发展综合因子指数ETF
DEEP=收购者深度价值ETF
DEF=防御股票指数ETF
DEH=D8 Holdings
DEI=道格拉斯艾美特
DELL=戴尔科技
DEM=新兴市场高股息ETF
DEN=丹博里
DEO=帝亚吉欧
DES=小盘股红利指数ETF
DESP=Despegar.com
DEUS=罗素综合因素指数ETF
DEW=全球高股息指数ETF
DFAE=新兴核心股票市场ETF
DFAI=维度国际核心股票市场
DFAU=维度美国核心股票市场
DFE=欧洲小盘股红利ETF
DFEN=精选航空航天和国防
DFIN=Donnelley Financial
DFJ=日本小盘红利指数ETF
DFNS=LGL Systems
DFS=发现金融
DG=达乐
DGL=DBIQ最优收益黄金指数
DGNR=Dragoneer Growth
DGP=黄金最佳产量两倍做多
DGRO=美国股息增长指数ETF
DGS=新兴市场小盘股红利
DGT=全球道琼斯指数ETF
DGX=奎斯特诊疗
DGZ=黄金最佳产量做空
DHF=BNY Mellon高收益策略
DHI=霍顿房屋
DHR=丹纳赫
DHRpA=丹纳赫优先A
DHS=美国高股息指数ETF
DHT=DHT控股
DHX=戴斯控股
DIA=工业平均指数ETF
DIAL=贝塔优势多部门债券
DIG=石油和天然气两倍做多
DIM=国际中盘股息指数ETF
DIN=Dine Brands Global
DIS=迪士尼
DIV=超低红利美国低波动率
DIVA=Indxx对冲股利收入
DIVZ=低波动率股票收益ETF
DJ=Dow Jones
DJCB=彭博商品指数ETF
DJD=工业平均产量加权指数
DJP=彭博商品指数ETF
DK=Delek Us控股
DKL=Delek Logistics
DKS=迪克体育用品
DL=正保远程教育
DLB=杜比实验室
DLN=美国大盘股股息
DLNG=Dynagas Lng
DLNGpA=Dynagas Lng A类优先
DLNGpB=Dynagas Lng B类优先
DLR=Digital Realty Trust
DLRpC=数码地产信托优先C
DLRpJ=数码地产信托优先J
DLRpK=数码地产信托优先K
DLS=国际小盘红利指数ETF
DLX=豪华
DLY=DoubleLine
DM=Desktop Metal
DMDV=股息和自由现金流收益
DMRE=100管理风险2.0指数
DMRI=标普EPAC风险管理指数
DMRL=标普500风险管理指数
DMRM=标普400管理风险2.0
DMRS=标普600风险管理指数
DMS=Digital Media
DMYD=dMY Technology
DMYI=Dmy Technology
DMYQ=dMY Technology
DNB=Dun & Bradstree
DNK=蛋壳公寓
DNL=全球非美质量股息增长
DNMR=Danimer Scientific
DNOW=Now
DNZ=D and Z Media
DOC=Physicians Realty
DOCN=DigitalOcean
DOG=工业平均指数做空
DOL=国际大盘股息指数ETF
DON=美国中盘股股息ETF
DOO=国际股息金融类除外
DOOR=美森特
DOV=都福
DOW=Dow
DPST=银行选择行业三倍做多
DPZ=达美乐比萨
DQ=大全新能源
DRD=DRDGOLD
DRE=杜克房地产
DRH=Diamondrock
DRI=达登饭店
DRIP=油气开发选择行业ETF
DRN=房地产指数三倍做多
DRQ=Dril-Quip
DRS=Leonardo DRS
DRV=房地产指数三倍做空
DRW=全球房地产指数ETF
DS=Drive Shack
DSG=Diamond S Shipping
DSI=KLD 400社会指数ETF
DSSI=Diamond S Shipping
DSTL=馏分油的稳定性和价值
DSTX=国际基本稳定性和价值
DSX=黛安娜船舶
DSXpB=黛安娜船舶B类优先
DSpB=Drive ShackB类优先
DSpC=Drive ShackC类优先
DSpD=Drive ShackD类优先
DT=Dynatrace
DTD=美国股息指数ETF
DTE=DTE能源
DTH=国际高股息指数ETF
DTN=美国股息除金融外
DUG=石油和天然气两倍做空
DUK=杜克能源
DUKpA=杜克能源优先A
DURA=晨星股息估值指数
DUSL=工业选择行业三倍做多
DUST=黄金矿工2倍做空ETF
DVA=达维塔保健
DVD=多佛赛车
DVN=戴文能源
DVYA=选择股息50指数ETF
DVYE=新兴市场选择股息指数
DWIN=Delwinds
DWM=国际股票指数ETF
DWMF=国际多因素基金ETF
DWX=标准普尔国际股息机会
DX=德尼克斯投资
DXC=DXC Technology
DXD=道琼斯指数两倍做空
DXJ=日本对冲股票指数ETF
DY=戴康工业
DYFN=Angel Oak
DYHG=大盘动态对冲指数ETF
DYNF=美国股权因子轮换ETF
DZZ=黄金最佳产量两倍做空
E=埃尼石油
EAF=GrafTech
EAGG=美国综合ESG焦点指数E
EARN=Ellington
EASG=ESG领导人指数ETF
EAT=布林克国际
EB=Eventbrite
EBF=恩尼斯
EBND=地方货币多元指数ETF
EBR=巴西电力
EBR.B=巴西电力优先存托
EBS=Emergent
EC=哥伦比亚国家石油
ECC=Eagle Point Credit
ECH=智利IMI 25/50指数
ECL=艺康
ECLN=第一信托EIP碳影响ETF
ECNS=MSCI中国小盘股指数
ECOM=Channeladvisor
ECON=消费者巨头30指数ETF
ECOZ=ESG主动机会ETF
ED=爱迪生联合电气
EDC=新兴市场每日三倍做多
EDIV=标普新兴市场股息机会
EDN=恩普雷萨电力
EDOG=新兴部门股利指数ETF
EDOW=工业平均加权指数
EDR=Endeavor Group控股
EDU=新东方
EDV=美国20-30年平均债券
EDZ=新兴市场每日三倍做空
EEH=美国大盘股动量指数
EELV=标普新兴市场低波动率
EEM=MSCI新兴市场指数ETF
EEMD=股息现金流收益率指数
EEMO=景顺标普新兴市场动量
EEMS=新兴市场小盘股指数
EEMV=新兴市场最低波动指数
EEMX=新兴市场非化石燃料
EES=美国小盘股指数ETF
EET=新兴市场指数两倍做多
EEV=新兴市场指数两倍做空
EEX=Emerald Holding
EFA=欧澳远东指数ETF
EFAD=欧澳远东股息大师ETF
EFAV=欧澳远东最低波动率
EFAX=EAFE除化石燃料ETF
EFC=Ellington投资
EFG=欧澳远东增长指数ETF
EFIV=标普500 ESG指数ETF
EFIX=TCW新兴市场债券ETF
EFO=欧澳远东指数两倍做多
EFR=EV高级浮动利率信托
EFT=EV浮动利率收益信托
EFU=欧澳远东指数两倍做空
EFV=欧澳远东价值指数ETF
EFX=艾可菲
EFZ=欧澳远东指数做空
EGHT=8x8
EGO=埃尔拉多黄金
EGP=EastGroup Properties
EGPT=MVIS埃及指数ETF
EGY=瓦可能源
EHC=Encompass Health
EIC=Eagle Point Income
EIDO=印尼IMI 25/50指数ETF
EIG=Employers控股
EINC=北美能源基础设施指数
EIRL=全爱尔兰上限指数ETF
EIS=以色列上限指数ETF
EIX=爱迪生国际
EJAN=力量缓冲ETF-1月
EJUL=力量缓冲ETF-7月
EKAR=创新实验室下一代车辆
EL=雅诗兰黛
ELAN=Elanco Animal Health
ELD=新兴地方债务基金指数
ELF=e.l.f.美容
ELP=Energy优先存托
ELS=宜居生活资产信托
ELVT=Elevate Credit
ELY=卡罗韦高尔夫
EMAG=MVIS EM综合债券指数
EMBD=全球X新兴市场债券ETF
EMBH=利率对冲新兴市场债券
EME=埃姆科
EMFM=前沿市场准入指数ETF
EMLC=新兴市场全球核心ETF
EMLP=北美能源基础设施基金
EMMF=新兴市场多因素基金
EMN=伊士曼化工
EMNT=增强型短期活跃ESGETF
EMPW=Empower
EMQQ=互联网与电子商务
EMR=艾默生电气
EMSG=新兴市场ESG领导者
EMTY=零售店指数做空ETF
ENB=安桥
ENBL=Enable Midstream
ENFR=中游能源选择指数
ENIA=奈尔西斯
ENIC=Enel Chile
ENLC=Enlink Midstream
ENPC=Executive Network
ENR=劲量控股
ENRpA=劲量控股优先A
ENS=艾诺斯
ENTR=ERShares企业家ETF
ENV=Envestnet
ENVA=易诺华国际
ENVN=EnVen Energy
ENZ=恩佐生化
EOG=EOG能源
EOI=EV增强型收入基金
EOS=EV增强型收入基金II
EPAC=Enerpac Tool
EPAM=Epam系统
EPC=Edgewell个人护理用品
EPD=企业产品伙伴
EPHE=菲律宾IMI指数ETF
EPI=印度盈利指数ETF
EPOL=波兰指数IMI 25 / 50
EPP=亚太（日本除外）指数
EPR=娱乐房地产依托
EPRT=Essential Properties
EPRpC=EPR地产C类优先
EPRpE=EPR地产E类优先
EPRpG=EPR地产G类优先
EPS=美国大盘股指数ETF
EPU=MSCI秘鲁限制指数ETF
EPV=欧洲全市值两倍做空
EPWR=Empowerment
EQAL=等权重指数ETF
EQC=Equity Commonwealth
EQCpD=Equity优先D
EQD=Equity Distribution
EQH=Equitable控股
EQHA=EQ Health
EQL=精选行业平均权重
EQNR=Equinor
EQOP=美国股票机会ETF
EQR=公平住屋
EQS=Equus Total Return
EQT=EQT能源
EQWL=标普100等权重指数ETF
ERF=艾诺加能源基金
ERJ=ERJ航空
ERM=权益指标风险管理ETF
ERSX=NextGen企业家ETF
ERUS=俄罗斯指数25 / 50ETF
ERX=能源行业2倍做多ETF
ERY=能源行业指数2倍做空
ES=能源方案
ESE=ESCO科技
ESGA=可持续股票ETF
ESGC=Eros STX
ESGN=国际股票收益100指数
ESGS=可持续美国股票收益
ESI=Element Solutions
ESM=ESM Acquisition
ESNG=回报利差指数ETF
ESNT=Essent Group
ESPO=视频游戏与电子竞技
ESRT=帝国房产信托
ESS=埃塞克斯信托
ESTC=Elastic
ESTE=Earthstone能源
ET=能源转换
ETH=伊森艾伦室内装饰
ETHO=气候领导指数-美国ETF
ETM=安德康传播
ETN=伊顿
ETPpD=Energy Transfer优先D
ETPpE=Energy Transfer优先E
ETR=安特吉
ETRN=Equitrans Midstream
ETV=EV TMBW机会基金
ETWO=E2open Parent
ETY=EV税收管理型基金
EUDG=欧洲质量红利增长ETF
EUDV=欧洲股息大师指数ETF
EUFX=美元/欧元汇率做空
EUM=新兴市场指数做空
EUO=美元欧元汇率两倍做多
EURL=全市值每日三倍做多
EURN=Euronav
EUSA=美国等权重指数
EUSB=通用选择筛选指数ETF
EUSC=欧洲对冲小盘股股票
EV=伊顿万斯
EVA=Enviva合作伙伴
EVC=超视野传播
EVF=EV高级收入信托
EVH=Evolent Health
EVR=Evercore
EVRG=Evergy
EVRI=Everi Holdings
EVT=EV TADI Fund
EVTC=Evertec
EVX=环境服务总回报ETF
EW=爱德华兹生命科学
EWA=MSCI澳大利亚指数ETF
EWC=加拿大自封顶指数ETF
EWCO=等权重通信服务增值
EWD=瑞典25/50指数ETF
EWG=MSCI德国指数ETF
EWH=MSCI香港指数ETF
EWI=意大利25/50指数ETF
EWJ=MSCI日本指数ETF
EWK=比利时IMI 25/50指数
EWL=瑞士25/50指数ETF
EWM=MSCI马来西亚指数ETF
EWMC=中盘400等权重指数ETF
EWN=荷兰投资市场指数ETF
EWO=奥地利IMI 25/50指数
EWP=西班牙25/50指数
EWQ=MSCI法国指数ETF
EWRE=等权重房地产指数
EWS=新加坡指数ETF
EWSC=小盘600等权重指数ETF
EWT=台湾指数-MSCI
EWU=MSCI英国指数ETF
EWV=MSCI日本指数两倍做空
EWW=墨西哥IMI 25/50指数
EWX=新兴市场市值小于20亿
EWY=韩国25/50指数ETF
EWZ=MSCI巴西25/50指数
EXG=EV税收管理型全球基金
EXI=全球1200工业行业指数
EXK=Endeavour Silver
EXP=老鹰材料
EXPR=Express
EXR=外太空储蓄
EXTN=Exterran
EZA=南非指数ETF-MSCI
EZJ=日本指数两倍做多
EZM=美国中盘股指数ETF
EZU=EMU指数-MSCI
F=福特汽车
FACA=Figure Acquisition
FACT=Freedom I
FAF=第一美国
FAII=Fortress Value
FAN=ISE全球风能指数ETF
FAS=金融服务指数三倍做多
FAZ=金融服务指数三倍做空
FBC=弗拉格斯塔万通金控
FBGX=增长指数两倍做多ETN
FBHS=Fortune Brands
FBK=FB金融
FBND=总债券ETF
FBP=第一万能金控
FBT=高增长板市场生物技术
FC=富兰克林柯维
FCAX=Fortress Capital
FCF=第一联邦金融
FCG=天然气指数ETF
FCN=FTI咨询
FCOM=电信服务25/50指数ETF
FCOR=公司债券ETF
FCPT=四角财产信托
FCX=Freeport-McMoRan
FDD=欧洲精选股利30ETF
FDHY=Fidelity高产因子ETF
FDIS=非必需消费品指数ETF
FDL=晨星股息领先指数ETF
FDLO=美国低波动系数
FDM=道琼斯选择微型指数
FDMO=美国动量因子指数ETF
FDN=互联网综合指数ETF
FDP=戴尔蒙特新鲜制造
FDRR=升息股利指数ETF
FDS=辉盛研究系统
FDVV=富达高股息指数ETF
FDX=联邦快递
FE=第一能源
FEDU=四季教育
FENG=凤凰新媒体
FENY=投资市场能源指数ETF
FERG=Ferguson
FET=Forum能源科技
FEUL=欧洲50指数2倍做多
FEVR=大盘股动量ESG ETF
FEZ=欧洲斯托克50指数ETF
FF=Futurefuel
FFG=FBL金融
FFIU=无约束中期固定收益
FFR=富时发展指数ETF
FFTY=IBD 50指数ETF
FGD=道琼斯全球精选股息
FGNA=Fg New
FGNB=FG New America
FHI=联邦投资
FHLC=投资市场保健指数ETF
FHN=第一地平线
FHNpA=第一地平线存托优先A
FHS=长水教育集团
FI=弗兰克国际
FICO=Fair Isaac
FIDI=富达国际高分红指数
FIDU=美国IMI工业指数ETF
FIEE=STOXX欧洲50两倍做多
FIGB=富达投资级债券ETF
FIHD=世界高股息率两倍做多
FILL=精选能源生产商IMI
FINS=天使橡树金融策略
FINV=信也科技
FIS=富达国民信息服务
FISR=SSGA固定收益部门轮换
FITE=Kensho未来安全指数
FIVA=国际价值因素指数ETF
FIVG=蓝星5G通信指数ETF
FIW=ISE水指数ETF
FIX=Comfort Systems USA
FJNK=全球重点高收益ETF
FL=富乐客
FLAU=富时澳洲RIC封顶指数
FLAX=富时亚洲除日本RIC
FLBR=富时巴西RIC封顶指数
FLCA=加拿大RIC封顶指数
FLCB=自由美国核心债券ETF
FLCH=富时中国RIC封顶指数
FLCO=富兰克林自由投资企业
FLEE=欧洲发达国家封顶指数
FLEH=欧洲发达国家对冲美元
FLFR=富时法国RIC封顶指数
FLGB=富时英国RIC封顶指数
FLGE=罗素1000增长指数ETF
FLGR=富时德国RIC封顶指数
FLGV=自由美国国债ETF
FLHK=富时香港RIC封顶指数
FLIN=富时印度RIC封顶
FLIX=Punchflix
FLIY=意大利RIC封顶指数
FLJH=日本RIC对冲至美元ETF
FLJP=富时日本RIC封顶指数
FLKR=富时韩国RIC封顶指数
FLLA=富时拉丁美洲上限指数
FLLV=美国自由低波动性ETF
FLM=全球工程建设指数ETF
FLMB=自由联邦免税债券ETF
FLME=Flame Acquisition
FLMI=自由联邦免税债券机会
FLMX=墨西哥RIC封顶指数
FLNG=FLEX LNG
FLO=花苑食品
FLOT=美国浮动利率债券ETF
FLOW=弗洛国际
FLQD=全球红利指数ETF
FLQE=新兴市场指数ETF
FLQG=LibertyQ全球股票指数
FLQH=国际股票对冲指数ETF
FLR=福陆
FLRG=美国多因素指数ETF
FLRN=浮动利率债券小于5年
FLRT=太平洋全球高级贷款
FLRU=富时俄罗斯RIC封顶
FLS=福斯
FLSA=富时沙特阿拉伯指数
FLSP=自由系统风格溢价ETF
FLSW=富时瑞士RIC封顶指数
FLT=FleetCor科技
FLTB=有限公司长期债券ETF
FLTR=MVIS投资浮动利率指数
FLTW=富时台湾RIC封顶指数
FLUD=自由超短债券ETF
FLY=巴布科克和布朗航空
FLYA=SOAR Technology
FLYT=Direxion避险策略ETF
FLZA=富时/JSE南非上限指数
FM=前沿市场100指数-Msci
FMAC=Firstmark
FMAT=投资市场材料25/50
FMC=FMC
FMF=管理期货策略基金ETF
FMO=F/C能源基础设施基金
FMS=费森尤斯医疗
FMX=墨西哥经济开发
FN=Fabrinet
FNB=F.N.B.
FNBpE=F.N.B.优先存托
FNCL=投资市场金融25/50
FND=地板装饰控股
FNDA=基本美国小型公司指数
FNDB=罗素RAFI美国ETF
FNDC=RAFI非美发达小型企业
FNDE=大型公司新兴市场ETF
FNDF=非美基金大型公司指数
FNDX=基本美国大型公司指数
FNF=富达国民金融A
FNGD=FANG+指数3倍做空ETN
FNGO=FANG+指数2倍做多
FNGS=FANG+指数ETF
FNGU=FANG+指数3倍做多ETF
FNGZ=FANG+指数2倍做空
FNI=ISE ChIndia指数ETF
FNV=弗兰科-内华达
FOA=Finance Of America
FOE=费罗
FOR=福里斯特
FOUR=Shift4 Payments
FOVL=聚焦值选择指数
FPAC=Far Peak
FPE=优先证券及收益ETF
FPEI=第一信托首选证券收入
FPH=五点控股
FPI=Farmland
FPIpB=Farmland B类优先
FPX=全球新股综合指数
FQAL=美国品质因子指数ETF
FR=第一工业地产
FRAK=全球石油和天然气气体
FRC=First Republic Bank
FRCpF=第一共和银行优先F
FRCpH=第一共和银行优先H
FREL=美国IMI房地产指数ETF
FRI=美国REIT指数
FRLG=罗素1000增长做多ETF
FRO=前线海运
FRT=FRT信托
FRTY=Alger中盘股40 ETF
FRX=Forest Road
FRXB=Forest Road
FSEC=富达投资级证券化ETF
FSK=FS KKR Capital
FSKR=FS KKR Capital
FSLY=Fastly
FSM=Fortuna银矿
FSMB=短期管理市政ETF
FSMD=中小型多因素指数ETF
FSNB=Fusion Acquisition
FSR=Fisker
FSS=联邦信号
FST=Fast Acquisition
FSTA=投资市场必需消费品
FTAI=丰泽运输和基础设施
FTCH=Farfetch
FTEC=美国投资市场信息技术
FTEV=FinTech Evolution
FTHY=First Trust
FTI=TechnipFMC
FTK=Flotek工业
FTLS=多/空权益ETF
FTS=Fortis
FTSD=自由短期美国政府ETF
FTV=Fortive
FTVpA=Fortive优先A
FUBO=fuboTV
FUE=商品指数额外生物燃料
FUL=富乐
FUMB=超短期市政ETF
FUN=雪松娱乐
FUSE=Fusion Acquisition
FUTY=美国公用事业25/50
FVAL=美国价值因子指数ETF
FVD=价值线分红基金
FVIV=Fortress Value
FVRR=Fiverr国际
FVT=Fortress Value
FWDB=智能核心债券ETF
FXA=美元/澳元汇率ETF
FXB=美元/英镑汇率
FXC=美元/加元汇率ETF
FXD=非必需消费品指数ETF
FXE=美元/欧元汇率ETF
FXF=美元/瑞士法郎汇率
FXG=必需消费品指数ETF
FXH=保健指数ETF
FXI=富时中国指数美元净值
FXL=技术指数ETF
FXN=能源指数ETF
FXO=财务指数ETF
FXP=美元净值两倍做空
FXR=工业指数ETF
FXU=公用事业指数ETF
FXY=美元/日元汇率ETF
FXZ=材料指数ETF
FYLD=外国股东收益率ETF
FZT=FAST Acquisition
G=简伯特
GAA=全球资产配置ETF
GAL=SSgA全球配置ETF
GAMR=REFND视频游戏技术
GAPA=G&P Acquisition
GATO=Gatos Silver
GATX=Gatx
GAZ=彭博天然气分类指数
GB=Global Blue
GBDV=Beta智能收入指数ETF
GBF=美国政府/信用债券
GBGR=新星指数-基准TR总额
GBIL=0-1年综合选择指数ETF
GBL=GAMCO投资
GBLO=低Beta因子指数ETF
GBUG=黄金3个月指数ETF
GBX=格林布赖尔
GCC=增强商品战略基金ETF
GCI=Gannett
GCO=格涅斯科
GCOR=投资级债券指数ETF
GCP=Gcp应用技术
GD=通用动力
GDDY=Godaddy
GDMA=动态多资产ETF
GDOT=Green Dot
GDX=NYSE Arca黄金矿工ETF
GDXD=黄金矿工3倍反向杠杆
GDXJ=全球初级黄金矿业指数
GDXU=黄金矿工3倍杠杆ETN
GE=通用电气
GEF=格瑞夫A
GEF.B=格瑞夫B
GEL=Genesis能源
GEM=新兴市场股票指数ETF
GEN=创世纪医疗
GEO=GEO惩教集团
GERM=治疗测试进步指数ETF
GES=Guess
GFF=格里丰
GFI=金田
GFL=GFL Environmental
GFOR=Graf Acquisition
GFX=Golden Falcon
GGB=盖尔道钢铁优先存托
GGG=固瑞克
GGI=Guggenheim Special
GGM=Guggenheim信贷分配
GGRW=加贝利成长创新者ETF
GHC=格雷厄姆控股
GHG=格林酒店
GHL=格林希尔事务所
GHLD=Guild Holdings
GHM=Graham
GHYB=高收益公司债券指数
GIB=CGI
GIGB=进入投资级企业债券
GII=标普全球基础设施指数
GIK=GigCapital3
GIL=吉登运动服
GINN=高盛创新股票ETF
GIS=通用磨坊
GIX=GigCapital2
GKOS=Glaukos
GL=Globe Life
GLCN=全盘成长领袖指数ETF
GLD=黄金现货ETF
GLDM=黄金现货ETF
GLEO=Galileo Acquisition
GLIF=AGFiQ全球基础设施ETF
GLIN=全盘成长领导指数ETF
GLK-1=Great Lakes
GLL=黄金分类指数两倍做空
GLOB=Globant
GLOG=Gaslog
GLOP=Gaslog Partners
GLOPpA=Gaslog优先
GLOPpB=Gaslog优先B
GLOPpC=Gaslog优先C
GLP=伙伴全球
GLPpA=伙伴全球优先A
GLRY=中盘股动量ESG ETF
GLT=Glatfelter
GLTR=实体贵金属指数ETF
GLW=康宁
GM=通用汽车
GME=游戏驿站
GMED=Globus医疗
GMF=标普亚太新兴BMI指数
GMOM=全球动量指数ETF
GMRE=Global Medical Reit
GMREpA=Global Medical优先A
GMS=GMS
GNAF=FANG+指数做空ETF
GNE=Genie Energy
GNEpA=Genie电力优先
GNK=根科船务贸易
GNKO=Ginkgo Residential
GNL=Global Net Lease
GNLpA=Global Net优先A
GNPK=Genesis Park
GNR=标普全球自然资源指数
GNRC=Generac控股
GNW=通用金融
GOAC=GO Acquisition
GOAT=护城河焦点指数ETF
GOAU=黄金和贵金属矿物ETF
GOEX=全球黄金勘探与开发
GOL=勒莫国航优先存托
GOLD=巴里克黄金
GOLF=高仕利控股
GOOS=加拿大鹅
GOVT=美国国债核心债券
GPC=通用配件
GPI=汽车一组
GPK=图形包装
GPMP=GPM Petroleum
GPMT=Granite Point信托
GPN=环汇
GPRK=地质公园
GPS=盖普
GPX=GP战略教育
GQRE=全球质量房地产指数
GRA=格雷斯事务所
GRAF=Graf Acquisition
GRC=The Gorman-Rupp
GREK=希腊25/50指数ETF
GRES=IQ全球资源ETF
GRN=全球碳II指数ETF
GRNB=绿色债券精选指数ETF
GRU=商品指数额外谷物ETF
GRUB=Grubhub
GS=高盛
GSAH=GS Acquisition
GSBD=Goldman Sachs Bdc
GSEU=欧洲股票指数ETF
GSG=标普GSCIETF
GSIE=国际股票指数ETF
GSIG=公司债券1-5年指数ETF
GSJY=日本股票指数ETF
GSK=葛兰素史克
GSL=环球租船
GSLC=美国大盘股指数ETF
GSLpB=全球船舶租赁B类优先
GSP=标普GSCIETF
GSPY=Gotham增强型500 ETF
GSQD=G Squared Ascend I
GSSC=高盛活性小盘股权指数
GSX=跟谁学
GSY=景顺超短期ETF
GSpA=高盛A类存托优先
GSpC=高盛C类存托优先
GSpD=高盛D类存托优先
GSpJ=高盛J类存托优先
GSpK=高盛K类存托优先
GTES=Gates Industrial
GTLS=查特工业
GTN=格林电视
GTN.A=格林电视A类普通
GTO=总回报债券ETF
GTOO=Graf Acquisition
GTS=三S管理
GTT=GTT Communications
GTWY=Gateway赌场娱乐
GTY=格蒂房地产
GUNR=全球上游自然资源指数
GURU=Guru指数ETF
GUSH=油气开发行业2倍做多
GVA=花岗岩建筑
GVAL=全球价值ETF
GVI=美国中级政府信用债券
GVIP=高盛对冲基金VIP指数
GWB=Great Western银行
GWRE=Guidewire软件
GWW=固安捷
GWX=发达国家市值小于20亿
GXC=标普中国BMI指数ETF
GXF=富时北欧30指数ETF
GXG=哥伦比亚25/50指数ETF
GYLD=全球综合收益指数
H=凯悦酒店
HACK=信息安全工程网络安全
HAE=美国血液技术
HAIL=智能交通指数ETF
HAL=哈里伯顿
HAP=自然资源指数ETF
HART=IQ健康之心ETF
HASI=Hannon Armstrong
HAUZ=非美国PK VN房地产ETF
HAWX=除美国外美元对冲指数
HAYW=Hayward Holdings
HBB=Hamilton海滩品牌
HBI=哈尼斯品牌服装
HBM=Hudbay矿产
HCA=HCA健康护理
HCC=Warrior Met Coal
HCHC=HC2控股
HCI=HCI集团
HD=家得宝
HDAW=非美高股息收益率ETF
HDB=HDFC银行
HDEF=高股息收益率指数ETF
HDG=因素模型-交换系列ETF
HDGE=Ranger股票做空ETF
HDIV=AI增强美国高股息ETF
HDLB=高股息指数2倍做多ETF
HDMV=管理波动率国际开发
HDV=股息收益率福克斯指数
HE=夏威夷电力
HEDJ=欧洲对冲股票指数ETF
HEEM=新兴市场100%美元对冲
HEFA=EAFE 100%对冲美元
HEI=海科航空
HEI.A=海科航空A类普通
HEP=霍利能源
HES=赫斯材料
HESM=Hess Midstream
HEWC=加拿大100%美元对冲
HEWJ=日本100%对冲美元ETF
HEWU=英国美元对冲指数ETF
HEWW=墨西哥美元对冲指数
HEXO=HEXO
HEZU=100%美元对冲指数ETF
HFC=霍利
HFRO=Highland Income
HFXI=富时发展50%美元对冲
HGLB=高地全球分配基金
HGV=Hilton Grand
HHC=The Howard Hughes
HHLA=HH&L Acquisition
HI=希伦布兰德
HIBL=高贝塔指数3倍做多ETF
HIBS=高贝塔指数3倍做空ETF
HIG=哈特福德金融服务
HIGA=H.i.g. Acquisition
HIGpG=哈特福德金融优先G
HII=Huntington Ingalls
HIL=希尔国际管理
HIMS=Hims & Hers Health
HIPR=罗素1000高增长ETF
HIPS=TFMS HIPS 300指数ETF
HIW=海伍兹物业
HJPX=400净收益美元对冲
HKIB=尚乘国际
HKND=Humankind美国股票
HL=赫克拉矿业
HLF=Herbalife Nutrition
HLI=华利安
HLT=希尔顿酒店
HLX=螺旋能源
HLpB=赫克拉矿业优先B
HMC=本田
HMLP=Hoegh Lng
HMLPpA=Hoegh Lng优先A
HMN=霍勒斯曼恩
HMOP=哈特福德市政债券机会
HMY=哈莫尼黄金
HNGR=Hanger
HNI=HNI
HNP=华能国际
HNRA=HNR Acquisition
HOG=哈雷戴维森
HOLD=Sage核心储备ETF
HOME=At Home Group
HOMS=Caliber
HOMZ=霍亚资本房屋100指数
HON=霍尼韦尔
HOV=霍夫纳尼安
HP=赫尔默里奇和佩恩材料
HPE=惠普企业
HPP=哈德森太平洋地产
HPQ=惠普
HPR=HighPoint Resources
HPX=HPX
HR=医疗保健房地产信托
HRB=HR布洛克服务
HRC=希尔罗控股
HRI=Herc Holdings
HRL=荷美尔食品
HRTG=Heritage Insurance
HSBC=汇丰控股
HSC=哈斯科材料
HSCZ=小盘对冲美元指数ETF
HSMV=管理波动性中小型ETF
HSY=好时
HT=HT基金
HTA=美国医疗保健信托
HTAB=税务意识债券ETF
HTEC=医疗技术创新指数ETF
HTGC=海格投资
HTH=希尔托普控股
HTPA=Highland
HTRB=哈特福特总收益债券
HTUS=Hull战术美国ETF
HTpC=HT基金C类优先
HTpD=HT基金D类优先
HTpE=HT基金A类优先
HUBB=哈贝尔
HUBS=Hubspot
HUGS=USHG Acquisition
HUM=休曼纳
HUN=亨斯曼材料
HUSV=平台管理波动
HUYA=虎牙直播
HVT=哈弗蒂家具
HVT.A=哈弗蒂家具A类普通
HWM=Howmet Aerospace
HXL=赫氏
HY=海斯特-耶鲁物料运输
HYBB=美高收益约束指数ETF
HYD=巴克莱市政定制综合
HYDW=美元高收益公司总市场
HYEM=美国新兴市场流动性
HYG=流动高收益指数ETF
HYGH=利率对冲高收益债券
HYGV=高收益率公司债券指数
HYLB=高收益企业总市场指数
HYLD=高收益ETF
HYLN=Hyliion Holdings
HYLV=高收益低波动企业债券
HYMB=市政收益率指数ETF
HYS=0-5年美国高收益率
HYTR=CP高产趋势指数ETF
HYUP=美元高收益公司总市场
HZAC=Horizon Acquisition
HZN=Horizon Global
HZO=海上麦斯服务
HZON=Horizon
IAA=IAA
IACA=Ion Acquisition
IACB=ION Acquisition
IACG=国际汽车零部件
IAG=Iamgold
IAI=美国精选投资服务指数
IAK=美国精选保险指数ETF
IAT=美国精选区域银行指数
IAU=黄金现货ETF
IAUM=微型黄金信托ETF
IBA=Bachoco Industries
IBCE=2023到期优质公司
IBD=激发企业债券冲击ETF
IBDD=巴克莱2023年到期企业
IBDM=巴克莱2021年到期公司
IBDN=2022年12月到期公司
IBDO=巴克莱2023年到期公司
IBDP=巴克莱2024年到期公司
IBDQ=2025年12月到期公司
IBDR=巴克莱2026年12月到期
IBDS=巴克莱到期企业指数
IBDT=2028年12月到期企业
IBDU=2029到期公司指数ETF
IBDV=2030到期公司指数ETF
IBER=Ibere
IBM=IBM
IBMJ=市政系列2021指数ETF
IBMK=市政系列2022指数ETF
IBN=印度工业信贷投资银行
IBND=全球总公司美元指数
IBP=Installed Building
ICD=独立钻井合约
ICE=洲际交易所
ICF=房地产专业指数ETF
ICL=ICL Group
ICOL=哥伦比亚上限指数ETF
IDA=IDACORP
IDEV=核心MSCI国际开发市场
IDHQ=标普质量开发大中盘股
IDIV=累积股息指数2027系列
IDLV=标普国际开发低波动率
IDMO=标普美韩大中盘动量
IDNA=基因学和制药指数ETF
IDOG=国际部门红利指数ETF
IDRV=自动驾驶和电动汽车
IDT=万威B
IDU=美国公用事业指数ETF
IDV=道琼斯EPAC选择股息
IDX=MVIS印度尼西亚指数
IEFA=欧澳远东可投资指数
IEMG=新兴可投资市场指数
IEO=美国精选石油勘探生产
IEUR=欧洲IMIETF
IEV=加权平均欧洲350指数
IEX=IDEX
IEZ=美国精选石油设备服务
IFF=国际香精香料
IFS=Intercorp金融服务
IG=主要投资级别企业活动
IGBH=利率对冲长期公司债券
IGE=标普北美自然资源部门
IGLB=10年以上美国公司
IGM=北美技术行业指数ETF
IGN=北美技术-多媒体网络
IGT=国际游戏科技
IGV=北美技术软件指数ETF
IH=洪恩教育
IHAK=全球网络安全指数ETF
IHC=独立控股
IHDG=国际对冲优质红利增长
IHE=美国精选制药指数ETF
IHF=美国健康护理提供商
IHG=洲际酒店集团
IHI=美国精选医疗设备指数
IHY=全球发行人高收益约束
IIAC=Investindustrial
IIGD=投资级防御
IIGV=投资等级价值指数
IIPR=Innovative
IIPRpA=Innovative优先A
IJAN=EAFE功率缓冲ETF-1月
IJH=标普400中盘股指数
IJJ=标普400中盘价值指数
IJK=标普400中盘股增长ETF
IJR=标普600小盘股指数
IJS=标普600小盘价值指数
IJUL=EAFE功率缓冲ETF-7月
ILF=标普拉丁美洲40指数
ILFC=ILFC控股
ILTB=美国通用10年以上指数
IMAX=驰能设备
IMLP=标普MLP指数ETF
IMPX=Aea-bridges
IMTB=美国通用5-10Y指数ETF
IMTM=世界（美国除外）动量
INCO=印度消费者指数ETF
INDF=金融服务25/50指数ETF
INDL=印度指数每日2倍做多
INDS=基准工业房地产SCTR
INFL=通货膨胀受益人ETF
INFO=IHS Markit
INFY=印孚瑟斯
ING=荷兰国际
INGR=Ingredion
INKM=Ssga收入分配ETF
INN=峰会酒店置业
INNpD=峰会酒店置业优先D
INNpE=峰会酒店置业优先E
INSP=Inspire Medical系统
INSW=International
INT=全球燃料服务
INTF=世界多元化多因素指数
INVH=Invitation Homes
IO=离子地球物理
IOO=全球100指数ETF
IP=国际纸业
IPAC=亚太投资市场ETF
IPAY=移动支付指数ETF
IPFF=标普国际优先股指数
IPG=埃培智
IPI=Intrepid Potash
IPO=IPO指数ETF
IPOD=Social Capital IV
IPOE=Social Capital V
IPOF=Social Capital VI
IPOS=国际IPO指数ETF
IPV=InterPrivate
IPVA=InterPrivate II
IPVF=InterPrivate III
IQDE=国际质量红利防御指数
IQDF=国际质量红利指数
IQDY=国际质量红利动态指数
IQIN=IQ 500国际指数
IQLT=部门中性质量指数ETF
IQSI=ESG国际股票指数ETF
IQSU=ESG美国股票指数ETF
IQV=昆泰医药
IR=Ingersoll Rand
IRBO=机器人和人工智能
IRM=铁山
IRS=IRSA Investments
IRT=独立房地产信托
ISCF=世界小盘多因素指数
ISMD=小/中盘冲击均等重量
ISOS=Isos Acquisition
ISRA=以色列全球指数ETF
ISWN=Amplify黑天鹅ISWN
ISZE=全球非美小型指数ETF
IT=加特纳
ITA=美国精选国防指数ETF
ITB=美国精选住房建设
ITCB=CorpBanca
ITEQ=以色列全球技术指数
ITGR=Integer Holdings
ITM=无AMT中间城市指数ETF
ITOT=标普市场指数-iShares
ITT=ITT
ITUB=艾涛巴西联合银行
ITW=伊利诺伊机械
IVAN=Ivanhoe Capital
IVC=英伐凯
IVE=标普500价值指数
IVES=现实股份无人机指数
IVLU=世界增强价值指数ETF
IVOG=标普400中盘股增长
IVOL=利率波动通货膨胀ETF
IVOO=标普400中盘股指数ETF
IVOV=标普400中盘股价值
IVR=景顺抵押资本
IVRpA=景顺抵押资本A类优先
IVRpB=景顺抵押资本B类优先
IVV=标普500指数-iShares
IVW=标普500增长指数ETF
IVZ=景顺投资管理
IWB=罗素1000指数ETF
IWC=罗素微型市值指数ETF
IWD=罗素1000价值指数ETF
IWDL=罗素1000价值2倍做多
IWF=罗素1000增长指数ETF
IWFH=全球虚拟工作生活指数
IWFL=罗素1000增长2倍做多
IWL=罗素200强ETF
IWM=罗素2000指数ETF
IWML=罗素2000指数2倍做多
IWN=罗素2000价值指数ETF
IWO=罗素2000增长指数ETF
IWP=罗素中盘成长指数ETF
IWR=罗素中盘指数ETF
IWS=中盘价值指数ETF
IWV=罗素3000指数ETF
IWX=罗素200强价值ETF
IWY=罗素200强增长ETF
IX=欧力士
IXC=全球1200能源部门指数
IXG=全球1200金融业指数
IXJ=全球1200医疗行业指数
IXN=全球信息技术行业指数
IXP=标普全球通信服务上限
IXSE=印度前国有企业基金
IYC=美消费者服务指数ETF
IYE=美国石油和天然气指数
IYF=美国金融上限指数ETF
IYG=美国金融服务指数ETF
IYH=美国保健指数ETF
IYJ=美国工业指数ETF
IYK=美国消费品指数ETF
IYM=美国基本材料指数ETF
IYR=iShares美国房地产ETF
IYT=道琼斯交通平均指数
IYW=美国技术上限指数ETF
IYY=道琼斯美国指数
IYZ=美国精选电信指数ETF
J=雅各布工程
JAAA=AAA CLO ETF
JAGG=摩根大通美国综合债券
JAX=J亚历山大
JBGS=Jbg Smith
JBL=捷普
JBT=约翰宾技术
JCE=Nuveen核心股权基金
JCI=江森自控
JCTR=碳转型美国股票ETF
JDIV=摩根大通美国股息指数
JDST=黄金矿业每日2倍做空
JE=Just能源
JEF=杰富瑞金融
JELD=Jeld-wen Holding
JEPI=股票溢价收益ETF
JETS=全球喷气机指数ETF
JGLD=纯初等黄金矿工ETF
JHCS=多因素媒体与传播指数
JHEM=维度新兴市场指数
JHG=Janus Henderson
JHMA=尺寸材料指数ETF
JHMC=维度消费者自由ETF
JHMD=发达国际指数ETF
JHME=尺寸能量指数ETF
JHMF=维度财务指数ETF
JHMH=维度医疗指数ETF
JHMI=尺寸工业指数ETF
JHML=维度大盘股指数ETF
JHMM=尺寸中型股指数ETF
JHMS=消费必需品指数ETF
JHMT=尺寸技术指数ETF
JHMU=维度效用指数ETF
JHSC=尺寸小盘股指数ETF
JHX=詹姆斯哈迪
JIG=摩根大通国际成长ETF
JIGB=企业债券研究增强型
JIH=Juniper Industrial
JILL=J.Jill
JJA=彭博农业指数总回报
JJC=彭博铜指数总回报ETF
JJE=彭博能源指数总回报
JJG=谷物分项指数总回报
JJM=工业金属指数总回报
JJN=彭博镍指数总回报ETF
JJP=贵金属分项指数总回报
JJS=彭博软件子指数总回报
JJT=彭博锡指数总回报ETF
JJU=彭博铝业指数总回报
JKD=晨星大核心美元总收益
JKE=高幅增长美元总收益
JKF=晨星高值美元总收益
JKG=晨星中心美元总收益
JKH=中期成长美元总收益
JKJ=小核心美元总收益
JKK=小幅增长美元总收益
JKL=晨星低值美元总收益
JKS=晶科能源
JLL=仲量联行
JMBS=抵押贷款证券ETF
JMIA=Jumia Technologie
JMIN=摩根大通最小波动率
JMOM=摩根大通美国动量因素
JMP=JMP集团
JNJ=强生
JNK=高收益非常流动性指数
JNPR=瞻博网络
JNUG=黄金矿业指数2倍做多
JO=咖啡分项指数总回报
JOE=圣乔
JOYY=消费者冠军指数ETF
JP=钜派投资
JPEM=新兴市场股票指数ETF
JPIN=多元化因素国际股票
JPM=摩根大通
JPMB=新兴市场风险意识债券
JPME=多元化因素美国中盘股
JPMpC=摩根大通EE类存托优先
JPMpD=摩根大通D类存托优先
JPMpG=摩根大通AA类优先股
JPMpH=摩根大通 BB 存托优先
JPN=400总回报指数ETF
JPSE=美国小盘股指数ETF
JPUS=多元化因素美国股票
JPXN=JPX-Nikkei 400总回报
JQUA=摩根大通美国质量因素
JSCP=摩根大通短期核心附加
JSTC=社会正义全市值全球
JT=简普科技
JUST=美国大盘多元化指数
JVAL=摩根大通美国价值因素
JW.A=John Wiley & Sons A
JW.B=John Wiley & Sons B
JWN=诺德斯特龙
JWS=Jaws Acquisition
JWSM=Jaws Mustang
JXI=全球1200公用事业指数
K=家乐氏
KAHC=KKR Acquisition
KAI=凯登纸业
KAMN=卡曼
KAR=KAR车行
KARS=Solactive电动汽车
KB=韩国国民银行
KBA=MSCI中国A指数ETF
KBE=标普银行选择性行业
KBH=厨卫家
KBR=KBR科技
KBUY=中金中国消费者领袖
KCAC=Kensington Capital
KCCB=中国企业高收益债券
KCE=标普资本市场选择行业
KCNY=多元化高级商业票据
KDFI=国债轮换指数ETF
KEMQ=消费者技术指数ETF
KEMX=新兴市场前中国指数
KEN=建安集团
KEP=韩国电力
KESG=ESG领导者1/4指数ETF
KEX=卡比海运
KEY=美国科凯国际
KEYS=Keysight技术
KEYpJ=美国科凯国际优先J
KEYpK=美国科凯国际优先G
KFS=汇富金融服务
KFVG=中金中国5G和半导体
KFY=Korn Ferry
KFYP=Zacks新中国指数ETF
KGC=金罗斯黄金
KGRN=MSCI中国IMI环境10/40
KIE=标普保险行业指数
KIF=Kayne Anderson收入
KIM=金克不动产
KIMpL=金克不动产L类优先
KIMpM=金克不动产存托优先M
KIO=KKR收入机会基金
KKR=Kkr & Co.
KKRpA=Kkr & Co.优先
KKRpB=Kkr & Co.优先B
KL=Kirkland Lake Gold
KLCD=股利选择权重指数ETF
KLDW=知识领袖世界发展ETF
KMB=金佰利
KMED=新兴市场医疗保健指数
KMI=金德尔摩根
KMLM=卢卡斯山指数策略ETF
KMPR=Kemper
KMT=肯纳金属
KMX=车美仕
KN=诺尔斯
KNL=海丘
KNOP=KNOT Offshore
KNX=Knight-Swift
KO=可口可乐
KODK=柯达
KOF=可口可乐凡萨瓶装
KOIN=资本链接下一代协议
KOKU=Kokusai指数ETF
KOLD=天然气指数两倍做空
KOMP=新经济综合指数ETF
KOP=科佩斯控股
KORP=世纪多元化公司债券
KORU=韩25/50每日三倍做多
KOS=Kosmos能源
KR=克罗格
KRA=科腾制药
KRBN=KFA全球碳ETF
KRC=吉劳埃地产
KRE=标普区域银行选择行业
KREF=KKR房地产金融信托
KRG=凯特地产信托
KRO=康诺斯全球
KRP=Kimbell Royalty
KSA=沙特阿拉伯IMI 25/50
KSCD=股利选择权重指数ETF
KSE-1=KeySpan
KSS=科尔士百货
KSTR=STAR市场50指数ETF
KSU=堪萨斯南方铁路
KSUp=堪萨斯南方铁路优先
KT=韩国电信
KTB=Kontoor Brands
KUKE=库客音乐
KURE=MSCI中国全部股票医疗
KVLE=价值线动态核心股票
KW=Kennedy-Wilson控股
KWAC=Kingswood
KWEB=CSI海外中国互联网
KWR=奎克化学
KXI=全球消费行业指数ETF
L=洛斯保险
LABD=技术选择行业三倍做空
LABU=生物技术行业三倍做多
LAC=Lithium Americas
LAD=利西亚车行
LADR=Ladder Capital
LAIX=流利说
LAZ=Lazard
LB=L品牌服装
LBAY=多头/空头另类收益ETF
LBJ=40指数2倍做多ETF
LBM=US LBM Holdings
LBRT=Liberty Oilfield
LC=Lendingclub
LCI=Lannett
LCII=LCI Industries
LCR=Leuthold核心ETF
LD=铅价总回报指数ETF
LDI=loanDepot
LDL=莱德尔
LDOS=Leidos Holdings
LDRS=IBD ETF领导者指数
LDUR=增强型低持续期主动型
LEA=李尔
LEAF=Leaf Group
LEAP=Ribbit Leap
LEE=李氏企业
LEG=礼恩派
LEJU=乐居
LEMB=新兴市场国家货币债券
LEN=莱纳
LEN.B=莱纳B类普通
LEND=贷款股权众筹指数ETF
LEVI=李维斯
LFC=中国人寿
LFEQ=美国大盘长/平指数ETF
LFT=Lument Finance
LGF.A=狮门娱乐A
LGF.B=狮门娱乐B
LGH=Defender 500指数ETF
LGI=Lazard全球收入基金
LGLV=大盘低波动率指数ETF
LGOV=First Trust长期机会
LGV=Longview
LH=美国控股实验室
LHC=Leo Holdings
LHX=L3Harris技术
LII=雷诺士
LIII=Leo Holdings
LIN=Linde
LINX=Linx
LIT=全球锂指数ETF
LITB=兰亭集势
LL=Lumber Liquidators
LLY=礼来
LMND=Lemonade
LMT=洛克希德马丁
LNC=林肯国民
LND=巴西农业不动产
LNFA=L&f
LNN=林赛
LOKB=Live Oak
LOKM=Live Oak Mobility
LOMA=Loma Negra
LOPP=Planet & People ETF
LOU=铁马收购
LOUP=卢普前沿技术指数
LOW=劳氏
LOWC=低碳目标指数ETF
LPG=Dorian LPG
LPI=Laredo石油
LPL=LG Display
LPX=路易斯安那太平洋
LQD=流动投资等级指数ETF
LQDH=利率对冲公司债券ETF
LRGF=美国多元多因素指数
LRN=Stride
LRNZ=技术智能深度学习ETF
LSAF=美国核心股票指数
LSAT=AlphaFactor战术重点
LSI=Life Storage
LSPD=Lightspeed
LSST=卢米斯塞尔斯短期收益
LTC=LTC房产
LTHM=Livent
LTL=美国精选电信两倍做多
LTPZ=15年以上通胀挂钩国债
LU=陆金所
LUB=卢比
LUMN=Lumen Technologies
LUV=西南航空
LVOL=美国世纪低波动ETF
LVS=金沙集团
LW=Lamb Weston控股
LXFR=Luxfer控股
LXP=莱星顿置业信托
LXPpC=莱星顿置业信托优先C
LXU=LSB工业材料
LYB=利安德巴塞尔
LYG=劳埃德银行
LYV=现场之国娱乐
LZB=La-Z-Boy家具
M=梅西百货
M00443=Tyco Flow Control
M01182=Guardion健康科学
M01196=Gofba
M01200=库欣收入和优先基金
M01201=RiverNorth机会基金II
M01204=Mallinckrodt
M01223=First Trust
M01227=Eaton Vance
M01230=RiverNorth
M01236=Western Asset
M01254=BlackRock 2040
M01256=BlackRock
M01257=Cardiva Medical
M01261=BlueRiver
M01271=Capitol Investment
M01274=Post Holdings
M01276=Tailwind Two
M01277=Virgin Group
M01278=Elliott
M01279=Elliott
M01283=Aspirational
M01284=Leo Holdings
M01286=涂鸦智能
MA=万事达
MAA=MAA房产信托
MAApI=MAA房产信托I类优先
MAC=马塞里奇房产
MACC=Mission
MAIN=主街资本
MAN=万宝盛华人力资源
MANU=曼联
MARB=第一信托合并套利ETF
MAS=马斯可木业
MATX=美森
MAX=Mediaalpha
MAXR=Maxar Technologies
MBAC=M3-Brigade
MBI=美国城市债券保险
MBT=移动电信
MC=Moelis A
MCB=Metropolitan Bank
MCD=麦当劳
MCK=麦克森
MCO=穆迪
MCRO=IQ对冲宏观指数ETF
MCS=马库斯
MCY=默邱利通用
MD=麦德纳斯服务
MDC=M.D.C. Holdings
MDH=MDH Acquisition
MDLA=Medallia
MDLY=Medley Management
MDP=梅瑞狄斯
MDQU=Madison Square资本
MDT=美敦力
MDU=MDU资源
MDY=标普400中盘股指数ETF
MDYG=标普400中盘股增长ETF
MDYV=标普400中盘股价值ETF
MEC=Mayville工程
MED=快验保
MEG=Montrose
MEI=梅索德电子
MET=大都会人寿
METpA=大都会人寿A类优先
MEXX=墨西哥IMI指数3倍做多
MFA=MFA抵押投资
MFApB=MFA抵押投资B类优先
MFC=宏利金融
MFDX=动态多因素开发指数
MFEM=多因素新兴市场指数
MFG=瑞穗金融
MFGP=Micro Focus国际
MFUS=动态多因素美国指数
MG=米斯特拉斯集团
MGA=曼格纳国际
MGC=CRSP美国大盘股指数
MGK=美国大盘增长指数ETF
MGM=美高梅
MGMT=Ballast中小盘股ETF
MGP=MGM Growth
MGV=美国大盘价值指数ETF
MGY=Magnolia Oil & Gas
MHK=莫霍克工业
MHO=MI 家居
MHpA=梅登控股A类优先
MHpD=梅登控股D类优先
MIC=麦格里基础设施
MID=中型股增长影响ETF
MIDE=标普中型股400 ESG
MIDF=中型股多元化指数ETF
MIDU=中盘股每日三倍做多
MIK-1=Michaels商店
MIL-1=Millipore
MINC=Newfleet多板块收益
MINT=增强型短期活跃ETF
MIT=Mason Industrial
MITT=AG按揭投资信托
MITTpA=AG按揭投资信托优先A
MITTpB=AG按揭投资信托优先B
MIXT=混合远程信息处理
MJ=主要替代收获指数ETF
MJJ=北美大麻指数ETF
MJO=大麻指数2倍做多ETF
MKC=味好美
MKC.V=味好美V
MKL=马克尔保险
ML=美利车金融
MLI=木勒工业
MLM=马丁-玛丽埃塔材料
MLN=AMT-Free长期市政ETF
MLP=毛伊岛菠萝食品
MLPA=MLP基础设施指数ETF
MLPB=MLP基础设施指数ETF
MLPO=标普MLP指数ETN
MLPR=MLP指数1.5倍做多ETF
MLPX=MLP和能源基础设施
MLPY=库欣MLP高收入指数ETN
MLR=米勒汽配
MMC=威达信
MMI=Marcus & Millichap
MMIN=巴克莱市政债券ETF
MMIT=巴克莱市政债券1-15年
MMLG=多经理大型增长ETF
MMM=3M
MMP=麦哲伦油气
MMS=马克西姆斯服务
MMTM=标普1500正动能倾斜
MN=Manning & Napier
MNA=IQ合并套利ETF
MNR=Monmouth房地产投资
MNRL=Brigham Minerals
MNRpC=Monmouth房地产优先C
MNSO=名创优品
MO=奥驰亚集团
MOAT=Wide Moat关注指数ETF
MOD=摩丁制造
MODN=Model N
MOG.A=穆格A
MOG.B=穆格B
MOGU=蘑菇街
MOH=莫利纳医疗
MOM=专题中性动量总回报
MOO=MVIS全球农业指数ETF
MOON=Kensho Moonshots ETF
MORT=美国房地产指数ETF
MOS=美盛
MOTI=全球非美护城河焦点
MOTO=智能交通科技ETF
MOTV=Motive Capital
MOV=摩凡陀
MP=MP Materials
MPC=马拉松原油
MPLN=MultiPlan
MPLX=Mplx
MPW=医疗不动产基金
MPX=海洋产品
MRAD=MSCI世界指数ETF
MRC=MRC全球
MRK=默克制药
MRO=马拉松石油
MS=摩根士丹利
MSA=MSA Safety
MSB=梅萨比投资
MSC=新濠影汇
MSCI=Msci
MSGE=Madison Square
MSGN=麦迪逊花园网络
MSGS=麦迪逊广场花园体育
MSI=摩托罗拉解决方案
MSM=MSC Industrial
MSOS=纯美国大麻ETF
MSP=Datto
MSpA=摩根士丹利A类优先
MSpI=摩根士丹利优先I
MSpK=摩根士丹利K类优先
MT=安赛乐米塔尔
MTB=美国制商银行
MTD=梅特勒-托利多
MTDR=Matador能源
MTG=MGIC投资
MTGP=抵押加债券基金ETF
MTH=Meritage Homes
MTL=车里雅宾斯克钢铁
MTLp=Mechel PAO存托优先
MTN=Vail Resorts
MTOR=美驰
MTR=梅萨皇家投资
MTRN=Materion
MTUL=美国动量指数2倍做多
MTUM=MSCI美国动量指数ETF
MTW=马尼托沃克
MTX=Minerals
MTZ=马斯科技大型工程
MUB=标普全国免税市政债券
MUFG=三菱日联金融集团
MUNI=中级市政债券活跃ETF
MUR=墨菲石油
MUSA=墨菲美国
MUST=多部门市政债券指数
MUX=McEwen Mining
MVO=MV石油信托
MVRL=房地产指数1.5做多ETF
MVV=标普400中盘两倍做多
MWA=穆勒集团
MX=海力士半导体
MXDU=最大多样化美国指数
MXI=全球1200材料行业指数
MXL=Maxlinear
MXLP=Maxum能源物流
MYE=迈尔斯工业股份
MYOV=Myovant Sciences
MYTE=MYT Netherlands
MYY=标普中盘股指数做空
MZZ=中盘股指数两倍做空
NACP=晨星少数民族赋权指数
NAIL=住房建设每日三倍做多
NANR=BMI北美自然资源指数
NAPA=TCW Special
NAPA-1=The Duckhorn
NAT=北欧美国油轮公司
NAV=纳威司达
NAVpD=航星国际D类优先
NBB=Nuveen Taxable
NBHC=National Bank控股
NBR=纳伯斯工业
NC=纳科工业
NCLH=挪威邮轮
NCR=NCR
NEA=纽文Amt-free优质市政
NEE=新纪元能源
NEM=Newmont
NEP=Nextera Energy
NEPG=Nep集团
NERD=电子竞技指数ETF
NET=Cloudflare
NETI=Eneti
NETL=基本收益净租赁房地产
NEU=纽马克特
NEW=朴新教育
NEWR=New Relic
NEX=NexTier Oilfield
NEXA=Nexa Resources
NFG=国家燃气
NFH=新风医疗
NFLT=多部门债券ETF
NFRA=全球广泛基础设施
NGA=Northern Genesis
NGAB=Northern Genesis
NGC=Northern Genesis
NGE=尼日利亚25/50指数ETF
NGG=英国电力
NGL=Ngl能源合作伙伴
NGLpB=Ngl能源合作伙伴优先B
NGLpC=Ngl能源合作伙伴优先C
NGS=天然气服务集团
NGVC=Natural Grocers
NGVT=Ingevity
NHF=NP战略机会基金
NHI=National Health
NI=尼索斯
NIB=可可指数总回报ETN
NIFE=Indxx美国落刀指数ETF
NINE=Nine Energy Service
NIO=蔚来
NIpB=尼索斯优先B
NJR=新泽西能源
NKE=耐克
NL=NL工业
NLR=全球铀和核能指数ETF
NLS=鹦鹉螺体育
NLSN=尼尔森
NLY=安纳利资本管理
NLYpF=安纳利资本管理优先F
NLYpG=安纳利资本管理优先G
NLYpI=安纳利资本管理优先I
NM=Navios海事控股
NMBS=Nuveen抵押和收入基金
NMCO=Nuveen市信用机会
NMM=纳维奥斯海运
NMR=野村控股
NMpG=Navios海事控股优先
NMpH=Navios海事控股优先H
NNA=纳维奥斯海上收购
NNI=尼尔网教育信贷
NNN=National Retail
NNNpF=NNN基金F类优先
NOA=北美建筑
NOAH=诺亚财富
NOBL=标普500高股利指数ETF
NOC=诺斯罗普・格鲁门
NOK=诺基亚
NOMD=Nomad Foods
NORW=挪威指数IMI25/50ETF
NOV=NOV
NOVA=Sunnova能源国际
NOW=ServiceNow
NP=尼拿纸业
NPK=帕斯托工业
NPO=恩佩罗工业
NPTN=Neophotonics
NR=新园能源
NREF=Nexpoint不动产
NRG=NRG能源
NRGD=大石油指数3倍做空ETF
NRGU=大石油指数3倍做多ETF
NRGX=Pimco基金
NRP=天然资源开采
NRT=北欧皇家石油信托
NRZ=新住宅投资
NRZpA=新住宅投资优先A
NS=纽星能源
NSA=National Storage
NSApA=National优先A
NSB=新生源
NSC=诺福克南方铁路
NSCO=Nesco Holdings
NSH=Navsight Holdings
NSP=Insperity
NSTB=Northern Star
NSTC=Northern Star
NSTD=Northern Star
NSpA=努什塔尔能源A类优先
NSpB=努什塔尔能源B类优先
NSpC=努什塔尔能源C类优先
NTB=Butterfield
NTCO=Natura &Co
NTG=Tortoise中游能源
NTP=南太集团
NTR=Nutrien
NTST=Netstreit
NTSX=90/60美国平衡基金ETF
NTZ=纳图兹家具
NUAG=增强收益美国广泛债券
NUBD=美国综合ESG选择指数
NUE=纽柯钢铁
NUGT=黄金矿工2倍做多ETF
NUHY=高收益ESG选择指数ETF
NUS=如新集团
NUSA=增加产量美国总体债券
NUSI=全国风险管理收入ETF
NUVB=Nuvation Bio
NVG=纽文Amt-free市政信贷
NVGS=导航控股
NVO=诺和诺德
NVQ=AI增强型美国下一价值
NVR=NVR
NVRO=Nevro
NVS=诺华
NVST=Envista Holdings
NVT=nVent Electric
NVTA=Invitae
NWG=NatWest Group
NWHM=The New Home Company
NWN=西北天然气
NX=夸斯建材
NXRT=Nexpoint住宅信托
NXU=Novus Capital
NYC=New York City
NYCB=纽约社区银行
NYCBpA=纽约社区银行存托优先
NYF=标普纽约免费市政债券
NYT=纽约时报
O=Realty Income
OACB=Oaktree
OACC=Oaktree
OAKpA=橡树资本优先A
OAKpB=橡树资本优先B
OBOR=MSCI基础设施暴露指数
OC=欧文斯科宁
OCA=Omnichannel
OCFT=金融壹账通
OCIO=OCIO ETF
OCN=奥克文货贷
ODC=美国石油勘探
OEC=猎户座工程碳
OEF=标普100指数
OEUR=欧洲质量股息指数ETF
OFC=Corporate Office
OFG=东方金融集团
OFGpA=东方金融集团A类优先
OFGpB=东方金融集团B类优先
OFGpD=东方金融集团D类优先
OGE=OGE能源
OGIG=全球互联网巨头指数
OGS=One Gas
OHI=Omega Healthcare
OI=O-I Glass
OIBR.C=OI
OIH=美国上市石油服务25
OII=国际海洋工程
OIL=原油纯贝塔TR指数ETN
OIS=石油斯特国际
OKE=欧尼克（万欧卡）
OLN=欧林
OLO=Olo
OLP=OLP房产信托
OMC=宏盟集团
OMF=OneMain Holdings
OMI=欧麦斯-麦能医疗
ONE=精锐教育
ONEO=动态聚焦因子指数ETF
ONEV=低波动率聚焦因子指数
ONEY=产量聚焦因子指数ETF
ONLN=ProShares在线零售
ONOF=自适应美国风险管理
ONTF=ON24
ONTO=Onto Innovation
OOMA=Ooma
OPA=Magnum Opus
OPER=ClearShares超短期
OPP=R/D战略机会基金
OPPX=Road战术机会ETF
OPY=奥本海默控股
OR=Osisko Gold
ORA=奥玛特科技
ORAN=Orange
ORC=Orchid Island
ORCC=Owl Rock Capital
ORCL=甲骨文
ORI=欧德共和国际
ORN=Orion Group Holdings
OSCR=Oscar Health
OSCV=Opus小盘价值ETF
OSG=海外航运集团
OSH=Oak Street Health
OSK=Oshkosh
OTIS=奥的斯
OUNZ=黄金现货ETF
OUSA=美国质量股息指数ETF
OUSM=美国小盘股优质股息
OUT=OUTFRONT Media
OVB=叠加股份核心债券ETF
OVF=叠加股票外国股票ETF
OVL=叠加股票大盘股ETF
OVLH=叠加股票对冲大盘股
OVM=叠加股票市政债券ETF
OVS=叠加股票小盘股ETF
OVT=叠加股票短期债券ETF
OVV=Ovintiv
OXM=牛津工业
OXY=西方石油
PAC=太平洋航空
PACE=Tpg Pace Tech
PACK=Ranpak Holdings
PAG=潘世奇汽车
PAGS=Pagseguro Digital
PAK=巴基斯坦25/50指数ETF
PALC=大盘指标旋转指数ETF
PALL=LBMA钯现货价格ETF
PAM=Pampa能源
PAMC=中型股多元化指数ETF
PANW=Palo Alto Networks
PAR=PAR技术
PARR=Par Pacific
PAYC=Paycom Software
PB=普罗斯佩里蒂银行
PBA=Pembina Pipeline
PBD=新能源全球创新指数
PBE=动态生物技术基因指数
PBF=PBF能源
PBFX=Pbf Logistics
PBH=普雷斯蒂奇
PBI=必能宝
PBJ=动态食品和饮料指数
PBP=标普BuyWrite指数ETF
PBR=巴西石油
PBR.A=巴西石油优先存托
PBS=动态媒体Intellidex
PBT=帕米亚盆地皇室信托
PBW=WilderHill清洁能源
PCEF=封闭式基金指数ETF
PCF=High Income
PCG=太平洋煤气和电力
PCOR=Procore
PCPC=Periphas Capital
PCY=新兴市场美元流动性
PD=PagerDuty
PDAC=Peridot
PDM=Piedmont办公室地产
PDN=开发非美中/小型ETF
PDO=PIMCO Tactical
PDOT=Peridot
PDS=精测勘探
PEAK=Healthpeak
PEB=Pebblebrook酒店信托
PEBpC=Pebblebrook酒店优先C
PEBpD=Pebblebrook酒店优先D
PEBpE=Pebblebrook酒店优先E
PEBpF=Pebblebrook酒店优先F
PEG=公共服务企业
PEI=宾夕法尼亚地产
PEIpB=宾夕法尼亚地产优先B
PEIpC=宾夕法尼亚地产优先C
PEIpD=宾夕法尼亚地产优先D
PEJ=动态休闲娱乐
PEN=Penumbra
PEXL=步行者美国出口领导人
PFE=辉瑞
PFFA=美国优先股ETF
PFFL=优先股指数三倍做多
PFFR=Indxx REIT优先股指数
PFFV=浮动利率证券指数ETF
PFGC=性能食品集团
PFIG=拉菲债券美国投资1-10
PFLD=优先混合证券指数ETF
PFS=公积金金融服务
PFSI=PennyMac金融服务
PFXF=混合和优先证券指数
PG=宝洁
PGAL=MSCI全葡萄牙加25/50
PGF=混合和优先证券金融
PGHY=全球短期高收益债券
PGM=白金指数总回报
PGR=美国前进保险
PGRE=Paramount Group
PGTI=PGT Innovations
PGX=优先组合-Powershares
PH=派克汉尼汾
PHB=拉菲美国高收益债券
PHDG=标普500下跌对冲ETF
PHG=飞利浦
PHI=菲律宾长途电话
PHM=帕尔迪
PHR=Phreesia
PHX=PHX Minerals
PHYL=活跃高收益债券ETF
PIAI=Prime Impact
PICB=标普国际公司债券指数
PICC=Pivotal Investment
PICK=精选金属和采矿生产商
PIFI=Piton中级固定收益ETF
PII=Polaris
PILL=制药行业指数3倍做多
PIN=印度质量选择指数ETF
PINE=Alpine Income
PING=Ping Identity
PINS=Pinterest
PIPP=Pine Island
PIPR=Piper Sandler
PJP=动态药物Intellidex
PJT=Pjt Partners
PK=Park酒店及度假村
PKB=动态建筑建筑指数
PKDP=帕克钻井优先
PKE=帕克航空航天
PKG=美国包装
PKI=珀金埃尔默
PKX=浦项钢铁
PLAN=Anaplan
PLAT=成长领袖指数ETF
PLD=安博
PLNT=星球健身
PLOW=道格拉斯动力
PLT=缤特力
PLTM=LBMA白金现货价格ETF
PLTR=Palantir
PLYM=Plymouth Industrial
PM=菲利普莫里斯
PMAR-1=Principal海上油轮
PMCA=Provident
PMOC=Putnam Mortgage
PMT=PennyMac Mortgage
PMTG=PIMCO抵押
PMTpA=PennyMac优先A
PMTpB=PennyMac优先B
PMVC=Pmv Consumer
PNC=PNC金融服务
PNCpP=PNC金融服务P类优先
PNM=PNM电力瓦斯
PNR=滨特尔
PNTM=Pontem
PNW=西帕纳卡资本
POR=波特兰通用电气
POST=Post Holdings
PPA=SPADE防御指数
PPG=PPG工业
PPL=PPL能源
PPLT=LBMA白金现货价格ETF
PPTY=美国多元化房地产
PQDI=税收优惠股息主动ETF
PQG=PQ Group Holdings
PQIN=战略阿尔法国际股票
PQLC=战略Alpha大型核心
PQSG=罗素2000增长指数ETF
PQSV=战略性阿尔法小盘市值
PRA=Proassurance
PRC=Pembrook Realty
PREpG=帕特纳瑞保险G类优先
PREpH=帕特纳瑞保险H类优先
PREpI=帕特纳瑞保险I类优先
PRF=富时RAFI美国1000指数
PRG=PROG Holdings
PRGO=培瑞克
PRI=Primerica
PRIFpC=优先收入基金优先C
PRIFpD=优先收入基金优先D
PRLB=Proto实验室
PRMI=Priam Properties
PRMW=Primo Water
PRO=PROS控股
PROS=ProSight Global
PRPB=Cc Neuberger
PRPC=CC Neuberger
PRSP=Perspecta
PRT=PermRock Royalty
PRTY=Party City Holdco
PRU=保德信金融
PSA=大众仓储
PSApC=大众仓储优先存托C
PSApE=大众仓储E类存托优先
PSApF=大众仓储优先存托F
PSApG=大众仓储G类存托优先
PSApH=大众仓储H类存托优先
PSB=PS商业园A系列
PSBpW=PS商业园A系列W类优先
PSBpX=PS商业园A系列X类优先
PSBpY=PS商业园A系列Y类优先
PSI=动态半导体Intellidex
PSJ=动态软件Intellidex
PSK=混合和优先证券综合
PSN=Parsons
PSO=培生
PSP=红岩全球上市私募股权
PSQ=NASDAQ100指数做空
PSR=活跃美国房地产ETF
PSRT=北极星房地产信托
PST=7-10年债券两倍做空
PSTG=Pure Storage
PSTH=Pershing Square
PSTL=Postal Realty Trust
PSX=Phillips 66
PSXP=Phillips 66 Partners
PTBD=美国债券指数ETF
PTIN=国际指数ETF
PTR=中国石油
PTY=PIMCO企业与收入机会
PUK=保诚保险
PULS=PGIM超短期债券ETF
PUMP=ProPetro Holding
PUTW=标普500PutWrite指数
PV=Primavera Capital
PVG=Pretium Resources
PVH=休森
PVI=彭博美国市政免税ETF
PVL=Permianville Royalty
PWB=动态大盘成长
PWC=动态市场Intellidex
PWR=广达
PWV=动态大盘价值
PWZ=长期核心市政证券指数
PXD=先锋自然资源
PXE=动力能源勘探生产指数
PXF=制定非美1000指数ETF
PXH=富时RAFI新兴市场指数
PXJ=石油服务Intellidex
PXQ=动态网络Intellidex
PYPE=皮肯斯核心中游指数
PZA=国家长期核心市政证券
PZD=清洁技术指数ETF
PZN=Pzena投资管理
PZT=纽约长期核心加城市
QAI=智能对冲多策略指数
QARP=罗素1000上限因子ETF
QD=趣店
QDEF=质量红利防御指数ETF
QDF=质量红利指数ETF
QDYN=质量红利动态指数ETF
QED=IQ对冲事件驱动
QEFA=欧澳远东混合A系列
QEMM=新兴市场混合A系列
QEP=QEP资源
QFTA=Quantum FinTech
QGEN=快而精医药
QGRO=美国世纪质量增长指数
QID=NASDAQ100两倍做空
QINT=世纪多元化国际股票
QLD=NASDAQ100两倍做多
QLS=智商对冲长/短期
QLTA=Aaa上限指数ETF
QLV=质量低波动率指数ETF
QLVD=质量低波动率指数ETF
QLVE=质量低波动性指数ETF
QMJ=质量0.3%递减指数ETF
QMN=智能对冲市场中性指数
QPT=Q投资组合混合分配ETF
QPX=Q动态增长ETF
QQH=Defender 100指数ETF
QQQE=NASDAQ100市值加权
QRFT=AI增强美国大盘股ETF
QS=QuantumScape
QSR=餐饮品牌国际
QSY=美国优质股东收益基金
QTS=QTS Realty Trust
QTSpB=QTS Realty优先B
QTUM=量子计算与机器学习
QTWO=Q2 Holdings
QUAD=Quad/Graphics
QUAL=MSCI美国行业中性质量
QULL=中性质量指数2倍做多
QUOT=Quotient Technology
QUS=美国因子组合A系列
QWLD=世界因子混合A系列
R=瑞德系统
RAAS=容联云
RAAX=矢量实物资产配置ETF
RACE=法拉利
RAD=来德爱
RAFE=RAFI ESG美国指数ETF
RALS=美国长短期指数ETF
RAMP=LiveRamp
RAVI=可变收益基金ETF
RAYC=Rayliant中国股票ETF
RBA=里奇兄弟拍卖
RBAC=Redball
RBC=雷勃电气
RBIN=基于风险的国际指数
RBLX=Roblox
RBND=美国企业ESG争议精选
RBUS=R基于风险的美国指数
RC=Ready Capital
RCD=平均加权非必需品消费
RCI=罗杰斯通信
RCL=皇家加勒比邮轮
RCUS=Arcus Biosciences
RDIV=超额指数ETF
RDN=瑞迪安集团
RDOG=REIT股息狗指数ETF
RDS.A=壳牌普通存托A
RDS.B=壳牌普通存托B
RDY=如瑞迪博士
RE=艾弗再险集团
RECS=研究增强美股指数ETF
REET=房地产投资信托ETF
REK=美国房地产指数做空
RELX=RELX
REM=全部抵押贷款上限ETF
REML=抵押贷款上限两倍做多
REMX=MVIS稀土/战略金属
RENN=人人
RES=RPC
RESP=美国ESG基金ETF
RETL=零售行业指数三倍做多
REV=露华浓
REVG=REV Group
REVS=研究增强价值指数ETF
REW=美国技术指数两倍做空
REX=雷克斯美国资源
REXR=雷克斯工业房地产
REXRpA=雷克斯工业房地产优先
REXRpB=雷克斯工业房地产优先
REZ=全部抵押住宅上限
REZI=Resideo Technologies
RF=地区金融
RFCI=动态核心收入ETF
RFDA=美国动态股息优势
RFFC=动态美国Flex-Cap ETF
RFG=中盘400纯增长指数ETF
RFL=Rafael Holdings
RFM=RiverNorth Flexible
RFMZ=RiverNorth
RFP=Resolute Forest
RFUN=动态无约束收入ETF
RFV=标普中盘股400纯价值
RFpA=地区金融存托优先
RFpB=地区金融B类存托优先
RFpC=地区金融优先C
RGA=美国再保险集团
RGI=等权重工业指数ETF
RGR=斯特姆-鲁格
RGS=里吉斯
RH=RH
RHI=罗伯特哈夫
RHP=莱曼酒店地产
RHS=平均加权/消费必需品
RICE=Rice Acquisition
RIG=越洋钻探
RIGS=战略收入基金ETF
RINF=通货膨胀预期ETF
RIO=力拓
RISN=激发战术平衡ESG ETF
RJA=商品指数-农业总回报
RJF=瑞杰金融
RJI=国际商品总回报ETF
RJN=国际商品-能源总回报
RJZ=国际商品-金属总回报
RKT=Rocket
RKTA=Rocket Internet
RL=拉夫劳伦
RLGY=Realogy控股
RLH=Red Lion Hotels
RLI=RLI保险
RLJ=RLJ住房信托
RLX=雾芯科技
RLY=多资产实际回报ETF
RM=Regional管理
RMAX=RE/MAX控股
RMD=瑞思迈
RMI=RiverNorth
RMM=RiverNorth市政收入
RMO=Romeo Power
RNG=RingCentral
RNGR=Ranger能源
RNR=复兴控股
RNRpE=复兴控股E类优先
RNRpF=复兴控股F类优先
ROAM=新兴市场股票指数ETF
RODI=功能障碍回报率指数
RODM=发达市场指数ETF
ROG=罗杰斯
ROK=罗克韦尔自动化
ROKT=Kensho最前沿指数ETF
ROL=罗林斯
ROM=美国技术指数两倍做多
ROOF=IQ美国房地产小额ETF
ROP=儒博实业
RORO=ATAC美国轮换ETF
ROSC=多因素小盘股指数ETF
ROSS=Ross Acquisition
ROT=Rotor Acquisition
ROUS=多因素大盘股指数ETF
RPAI=美国零售物业
RPAR=RPAR风险平价ETF
RPG=标普500纯增长ETF
RPLA=Replay Acquisition
RPM=RPM国际
RPT=RPT
RPV=净值指数ETF
RRC=Range资源
RRD=当纳利
RS=信实钢铝加工
RSF=RiverNorth
RSG=共和废品处理
RSI=Rush Street
RSP=等权重指数ETF
RSX=MVIS俄罗斯指数ETF
RSXJ=俄罗斯小盘股指数ETF
RTH=MVIS美国零售25指数
RTM=等权重材料指数ETF
RTP=Reinvent
RTPZ=Reinvent
RTX=Raytheon
RUSL=俄罗斯指数2倍做多ETF
RVI=Retail Value
RVLV=Revolve Group
RVNU=市政基础设施收入债券
RWGV=150/50净利差
RWJ=小盘股指数ETF
RWK=中盘股指数ETF
RWL=标普收益加权指数ETF
RWM=罗素2000指数做空ETF
RWO=全球精选房地产证券
RWR=美国精选REIT指数ETF
RWT=红木信托
RWVG=150/50净利差指数ETF
RWX=非美国选择房地产证券
RX-1=IMS Health
RXD=美国保健指数2倍做空
RXI=非必需消费品指数ETF
RXL=美国保健指数两倍做多
RXN=莱克斯诺
RY=加拿大皇家银行
RYAM=Rayonier Advanced
RYB=红黄蓝教育
RYE=等权重能源
RYF=等权重金融指数ETF
RYH=等权重保健指数ETF
RYI=Ryerson控股
RYJ=SB-1指数ETF
RYN=雷欧尼尔
RYT=等权重技术指数ETF
RYU=标普公用事业和电信
RYpT=加拿大皇家银行优先T
RZG=小盘股600纯成长ETF
RZV=小盘股600纯价值ETF
SA=海桥黄金
SAA=小盘股指数两倍做多
SAFE=Safehold
SAH=索尼克汽车
SAIC=科学应用
SAIL=Sailpoint科技
SAM=波斯顿啤酒
SAN=桑坦德银行
SAND=沙尘暴黄金
SAP=SAP SE
SAR=Saratoga投资
SAVE=Spirit航空
SB=安全集装
SBB=标普600小盘股做空
SBG=Sandbridge
SBH=Sally Beauty
SBII=Sandbridge X2
SBIO=医疗突破指数ETF
SBL-1=Symbol Tech
SBM=美国基本材料指数ETF
SBOW=SilverBow Resources
SBR=萨拜因皇家信托
SBS=SABESP
SBSW=Sibanye
SBUG=白银3个月指数ETF
SBpC=安全集装C类优先
SBpD=安全集装D类优先
SC=Santander
SCC=消费者服务两倍做空
SCCO=南方铜业
SCDL=2倍杠杆美国股息系数
SCEpJ=Southern优先J
SCEpL=Southern优先L
SCHA=美国股市小盘股ETF
SCHB=美国大宗股票市场指数
SCHC=发展小型流动性指数
SCHD=美国股息100指数ETF
SCHE=新华富时新兴指数ETF
SCHF=发展（美国除外）指数
SCHG=美国大盘成长股票市场
SCHH=道琼斯REIT指数ETF
SCHI=5-10年企业债券ETF
SCHJ=1-5年公司债券指数ETF
SCHK=Schwab 1000指数ETF
SCHM=道琼斯美国中盘总市值
SCHO=美国财政1-3年指数ETF
SCHP=美国通货膨胀保护指数
SCHQ=美国财政部指数ETF
SCHR=美国3-10年国债指数
SCHV=美国大盘市值整体股票
SCHW=嘉信理财
SCHWpC=嘉信理财C类优先
SCHWpD=嘉信理财D类优先
SCHX=美国大盘整体股票指数
SCHZ=美国综合债券指数ETF
SCI=国际服务
SCJ=日本小盘股ETF-MSCI
SCL=史提宾
SCM=Stellus资本投资
SCO=WTI原油指数两倍做空
SCPE=SC Health
SCS=斯迪凯思
SCU=Sculptor Capital
SCVX=SCVX
SCX=施泰力
SD=桑德里奇能源
SDCI=动态商品策略K-1基金
SDD=小盘股指数两倍做空
SDEF=健全增强固定收益ETF
SDEI=健全股权收益ETF
SDEM=50强分红指数ETF
SDGA=晨星社会发展指数
SDHY=PGIM Short Duration
SDIV=全球超级股息指数ETF
SDOG=部门股利指数ETF
SDOW=道琼斯指数三倍做空
SDP=美国公用事业两倍做空
SDS=标普500指数两倍做空
SDY=标普高收益率红利贵族
SE=冬海集团
SEAH=Sports Entertainment
SEAS=海洋世界
SEE=希悦尔包装
SEF=美国金融指数ETF
SEGR=东南杂货
SEIX=Seix高级贷款ETF
SEM=精选医疗集团
SEMR=SEMrush Holdings
SENT=阿尔法DNA股票情绪ETF
SF=Stifel金融
SFE=安科投资
SFL=SFL
SFTW=Osprey Technology
SFUN=房天下
SFY=美国500成长指数ETF
SFYF=SOFI社会50指数ETF
SFYX=未来500强增长指数ETF
SFpA=Stifel金融 优先A
SFpB=Stifel金融 优先B
SGDJ=初级黄金矿工指数ETF
SGDM=黄金矿工因素指数ETF
SGFY=Signify Health
SGG=彭博糖分项指数总回报
SGOL=黄金现货ETF
SGOV=美国国库券指数ETF
SGP=Schering-Plough
SGU=星辰天然气
SH=标普500指数做空
SHAK=Shake Shack
SHE=环球性别多样性指数
SHG=新韩金融
SHI=上海石化
SHLX=Shell Midstream
SHM=管理货币市场短期指数
SHO=太阳石酒店投资
SHOP=Shopify
SHOpE=太阳石酒店投资优先E
SHOpF=太阳石酒店投资优先F
SHW=宣威-威廉姆斯
SHYD=巴克莱市政高收益短期
SHYG=美元流动高收益指数
SHYL=美元高收益公司总市场
SI=Silvergate资本
SID=巴西国家黑色冶金
SIG=西格内特珠宝
SII=SPROTT
SIJ=美国工业指数两倍做空
SIL=全球银矿业指数ETF
SILJ=初级白银矿商和探险家
SIMS=智能基础设施指数ETF
SIO=SCS保险机会基金
SITC=SITE Centers
SITCpA=SITE A类存托优先
SITCpK=SITE K类存托优先
SITE=Siteone Landscape
SIVR=白银现货价格ETF
SIX=六旗娱乐
SIXA=兆丰帽股票ETF
SIXH=对冲股票指数期权策略
SIXL=低Beta股票策略ETF
SIXS=小盘股票ETF
SIZE=美国风险加权指数
SJB=流动高收益指数做空
SJI=南新州煤气
SJM=JM斯马克
SJNK=美国高收益指数ETF
SJR=肖氏通信
SJT=圣胡安皇室信托
SJW=SJW
SKF=美国金融指数两倍做空
SKLZ=Skillz
SKM=韩国SK电信
SKT=坦格尔直销中心
SKX=斯凯奇
SKY=Skyline Champion
SLAC=Social Leverage
SLB=斯伦贝谢
SLCA=U.S. Silica控股
SLD-1=Sutherland资产管理
SLF=永明金融
SLG=格林不动产
SLGpI=格林不动产I类优先
SLQT=SelectQuote
SLV=白银现货价格-iShares
SLVP=选择性银矿工IMI ETF
SLWD=太阳-风可再生能源
SLX=高增长板市场钢铁
SLY=标普600小盘股指数ETF
SLYG=标普小盘股增长ETF
SLYV=标普600小盘股价值ETF
SM=圣玛丽石油勘测
SMAR=Smartsheet
SMB=AMT-Free短期连续市
SMDD=标普400中盘三倍做空
SMDY=语法分层中型指数ETF
SMEZ=欧洲斯托克小盘指数
SMFG=三井住友金融
SMG=斯科兹物种
SMH=美国上市半导体25指数
SMHI=SEACOR Marine
SMLE=标普小型股600 ESG
SMLF=美国小盘多因素指数
SMLP=Summit Midstream
SMLV=小盘低波动指数ETF
SMMU=短期市政债券活跃ETF
SMN=基本材料指数两倍做空
SMOG=Ardour全球指数ETF
SMP=Standard Motor
SMY=萨摩耶互联网金融服务
SNA=实耐宝
SNAP=Snap
SNDR=Schneider National
SNE=索尼
SNII=Supernova Partners
SNN=施乐辉
SNOW=Snowflake
SNP=中国石化
SNPE=标普500 ESG指数ETF
SNPR=Tortoise
SNR=New Senior投资集团
SNS=Stewart & Stevenson
SNV=西诺乌斯金融
SNVpD=西诺乌斯金融优先D
SNVpE=西诺乌斯金融优先E
SNX=新聚思
SO=南方电力
SOAC=Sustainable
SOGO=搜狗
SOI=Solaris油田基础设施
SOL=瑞能新能源
SON=索诺科产品
SOR=Source Capital
SOS=SOS
SOVB=坎布里亚主权债券ETF
SOXL=半导体每日三倍做多
SOXS=半导体每日三倍做空
SOYB=大豆基金基准ETF
SPAB=美国综合债券指数ETF
SPAK=IndxxSPAC NextGenIPO
SPAQ=Spartan收购
SPB=科博控股
SPBO=企业债券指数ETF
SPCE=Virgin Galactic
SPCX=The SPAC和新发行ETF
SPD=美国股票加下行凸出
SPDN=标普500指数每日做空
SPDV=股息现金流收益率指数
SPDW=非美国已开发市场
SPEM=标普新兴BMI指数ETF
SPEU=欧洲总市场指数ETF
SPFF=北美优先股指数
SPFR=Jaws Spitfire
SPG=西蒙地产
SPGI=标普全球
SPGM=MSCI ACWI IMI指数ETF
SPGP=标普500GARP指数ETF
SPGS=Simon Property
SPGpJ=西蒙地产集团J类优先
SPH=Suburban Propane
SPHB=标普500高贝塔指数ETF
SPHD=标普低波动率高股息
SPHQ=标普500质量指数ETF
SPHY=美林银行美国高收益
SPIB=中级企业指数ETF
SPIP=美国政府通胀联动债券
SPLB=美国长期企业指数ETF
SPLG=标普500指数ETF
SPLP=Steel Partners控股
SPLPpA=Steel Partners优先A
SPLV=标普500低波动率ETF
SPMB=美国MBS指数ETF
SPMD=标普400中盘股指数ETF
SPMO=标普500动能指数ETF
SPNT=SiriusPoint
SPNV=Supernova
SPOT=Spotify Technology
SPR=Spirit Aerosystems
SPRE=全球房地产投资信托
SPRQ=Spartan
SPSB=美国公司1-3年指数ETF
SPSK=债券总回报指数ETF
SPSM=标普600小盘股指数ETF
SPTI=美国3-10年国债指数
SPTL=美国财政指数ETF
SPTM=标普综合指数1500ETF
SPTS=1-3年政府浮动调整
SPUC=美国股票加上凸性ETF
SPUS=行业排除指数ETF
SPUU=标普500每日两倍做多
SPVM=高动能价值指数ETF
SPVU=标普500增值价值指数
SPXB=标普500债券ETF
SPXC=斯必克
SPXE=标普500非能量指数ETF
SPXL=标普500每日三倍做多
SPXN=非金融房地产指数ETF
SPXS=标普500每日三倍做空
SPXT=前信息技术指数
SPXU=标普500指数三倍做空
SPXV=标普健康保险指数ETF
SPXX=Nuveen动态覆盖基金
SPXZ=Exos SPAC原始ETF
SPY=标普500ETF-SPDR
SPYC=美国股票加凸出ETF
SPYD=标普500高股息指数ETF
SPYG=标普500增长指数ETF
SPYV=标普500价值指数ETF
SPYX=标普500非化石燃料ETF
SQ=Square
SQEW=偏股型ETF
SQM=智利矿业化工
SQNS=Sequans通信
SQZ=Sqz Biotechnologies
SR=Spire
SRA=Sierra Income
SRC=Spirit Realty
SRCpA=Spirit Realty优先A
SRE=桑普拉能源
SREpB=桑普拉能源优先B
SRG=Seritage Growth
SRGpA=Seritage Growth优先A
SRI=斯通里奇
SRL=Scully Royalty
SRLN=黑石/GSO高级贷款ETF
SRLP=斯普拉格能源
SRS=美房地产指数两倍做空
SRT=StarTek
SRTY=罗素2000指数做空ETF
SRVR=基准数据和设施房地产
SRpA=Spire优先A
SSD=辛普森配件制造
SSG=美国半导体两倍做空
SSL=南非萨索尔
SSLY=语法分层小型指数ETF
SSMC=Gatos Silver
SSO=标普500指数两倍做多
SSPY=语法分层大盘股索引
SSTK=Shutterstock
SSUS=研究智能行业ETF
ST=Sensata
STAG=Stag工业
STAGpC=Stag工业C类优先
STAR=iStar
STARpD=iStarD类优先
STARpG=iStarG类优先
STARpI=iStarI类优先
STC=斯图尔特信息服务
STE=思泰瑞医疗
STG=尚德机构
STIC=Northern Star
STIP=美国国债0-5年指数
STL=纽约公积金合众银行
STLA=Stellantis
STM=意法半导体
STN=斯坦泰克
STNG=Scorpio Tankers
STON=StoneMor
STOR=Store Capital
STPC=Star Peak
STPK=Star Peak
STPZ=1-5年通胀挂钩国库
STRE=Supernova Partners
STST=Stalwart Tankers
STT=道富
STTpD=美国道富D类存托优先
STTpG=美国道富优先G
STWD=喜达屋不动产信托
STZ=星座品牌
STZ.B=星座品牌B类普通
SU=森科能源
SUB=标普短期免费市政债券
SUBZ=流媒体服务和技术ETF
SUI=Sun Communities
SUM=峰会材料
SUN=太阳石油
SUP=超级工业国际
SUPV=Grupo Supervielle
SUSA=MSCI美国ESG选择指数
SUZ=Suzano
SWAN=SNetwork黑天鹅核心
SWBK=Switchback II
SWBT=Switchback III
SWCH=Switch
SWI=SolarWinds
SWK=史丹利百得
SWM=施伟策・摩迪集团
SWN=西南能源
SWX=Southwest Gas控股
SXC=Suncoke能源
SXI=Standex国际
SXT=森馨
SYE=MFS系统核心股票ETF
SYF=Synchrony Financial
SYG=系统性成长股票ETF
SYK=史赛克
SYLD=股东收益ETF
SYV=MFS系统价值股票ETF
SYX=司德麦克斯
SYY=西斯科
SZC=Cushing NextGen
SZK=美国消费品两倍做空
SZNE=等重量季节性轮换指数
T=美国电话电报
TAAG=趋势聚集成长ETF
TAC=全美阿尔塔电力
TACA=Trepont
TACE=趋势聚集保守型ETF
TADS=趋势聚集股息股票ETF
TAGS=TAGS指数ETF
TAK=武田制药
TAL=好未来
TALO=Talos Energy
TAN=全球太阳能指数ETF
TAP=莫尔森库尔斯饮料B
TAP.A=莫尔森库尔斯饮料A
TARO=塔罗制药工业
TAXF=世纪多元化市政债券
TBA=Thoma Bravo
TBF=20年以上债券指数做空
TBI=真蓝
TBT=20年以上债券两倍做空
TBX=7-10年债券指数做空
TCHP=蓝筹股成长型ETF
TCI=洲际地产投资
TCP=TC PipeLines
TCS=容器商店集团
TD=多伦多道明银行
TDC=Teradata
TDG=TransDigm Group
TDOC=Teladoc Health
TDS=电话和数据系统
TDSA=Cabana目标下降5ETF
TDSB=Cabana目标下降7ETF
TDSC=Cabana目标下降10ETF
TDSD=Cabana目标下降13ETF
TDSE=Cabana目标下降16ETF
TDTF=5年目标持续时间提示
TDTT=3年目标持续时间提示
TDVG=股息增长ETF
TDW=潮水海运
TDY=泰里达因技术
TEAF=乌龟基本资产收入基金
TECB=美国技术突破指数ETF
TECK=泰克资源
TECL=高科技指数三倍做多
TECS=高科技指数三倍做空
TEF=西班牙电信
TEL=泰科电子
TEN=天纳克
TEO=阿根廷电信
TEQI=股权收益ETF
TERM=股权投资策略风险经营
TEVA=梯瓦制药
TEX=特雷克斯
TFC=Truist Financial
TFCPRF=BBT银行F类存托优先
TFCPRG=BBT银行G类存托优先
TFCpF=BBT银行F类存托优先
TFCpG=BBT银行G类存托优先
TFI=市政货币1-25指数ETF
TFII=TFI International
TFLO=美国国债浮动利率债券
TFX=泰利福
TG=特里迪加
TGH=Textainer控股集团
TGI=Triumph集团
TGIF=SoFi周收入ETF
TGLT=TGLT
TGNA=TEGNA
TGP=Teekay Lng Partners
TGPpA=Teekay Lng 优先A
TGPpB=Teekay Lng 优先B
TGRW=成长股票ETF
TGS=南部燃气股份有限公司
TGT=塔吉特
THC=泰尼特保健
THCX=实验室大麻指数ETF
THD=泰国IMI 25/50指数ETF
THG=汉诺威保险
THNQ=全球人工智能指数ETF
THO=Thor Industries
THR=Thermon控股集团
THS=树屋食品
TILT=美国因素倾斜指数ETF
TIMB=TIM
TINV=Tiga
TIP=美国财政通货膨胀保护
TIPX=美国政府通胀挂钩债券
TIPZ=美国通胀挂钩国库指数
TISI=Team
TIXT=TELUS International
TJX=TJX零售
TK=帝凯海运
TKC=土耳其移动通信
TKR=铁姆肯
TLGA=TLG Acquisition
TLH=ICE10-20年国债指数
TLK=印尼电信
TLTD=非美因素倾斜指数ETF
TLTE=晨星新兴市场因素倾斜
TLYS=Tilly's
TM=丰田汽车
TMAC=The Music
TME=腾讯音乐
TMF=20年以上债券三倍做多
TMHC=泰勒・莫里森家
TMO=赛默飞世尔
TMST=Timkensteel
TMV=20年以上债券三倍做空
TMX=Terminix
TNA=罗素2000三倍做多ETF
TNC=坦能
TNET=Trinet Group
TNK=Teekay油轮
TNL=Travel + Leisure
TNP=查科斯能源海运
TNPpD=查科斯能源海运优先D
TNPpE=查科斯能源海运优先E
TNPpF=查科斯能源海运优先F
TOK=Kokusai指数-MSCI
TOL=托尔兄弟
TOLZ=全球基础设施综合指数
TOOpA=铁凯航运A类优先
TOOpB=Altera优先B
TOOpE=Altera优先E
TOT=道达尔
TOTL=双线总回报战术ETF
TPB=Turning Point Brands
TPC=Tutor Perini建筑
TPGY=Tpg Pace
TPH=Tri Pointe Homes
TPHD=高股息加权BRI指数ETF
TPIF=波动加权BRI指数ETF
TPL=Texas Pacific Land
TPLC=大型股加权BRI指数ETF
TPOR=交通平均指数3倍做多
TPR=蔻驰
TPSC=小盘加权BRI指数ETF
TPVG=TriplePoint
TPX=丹普西利国际
TPYP=Tortoise北美管道指数
TR=宝贝卷糖业
TRAQ=Trine II
TRB=TRIBUNE
TRC=Tejon牧业
TRCA=Twin Ridge Capital
TREB=Trebia
TREC=Trecora Resources
TREX=Trex木业
TRGP=Targa资源投资
TRI=汤森路透
TRN=Trinity Industries
TRND=趋势领航基金指数ETF
TRNF=Taronis Fuels
TRNO=特雷诺房地产
TROX=Tronox控股
TRP=TC Energy
TRQ=绿松石山资源
TRTL=TortoiseEcofin
TRTN=特里同国际
TRTNpA=特里同国际优先A
TRTNpB=特里同国际优先B
TRTX=TPG RE Finance Trust
TRU=TransUnion
TRV=旅行者保险
TS=泰纳瑞斯钢铁
TSE=Trinseo
TSG-1=Sabre Holdings
TSLX=Sixth Street专业贷款
TSM=台积电
TSN=泰森食品
TSQ=Townsquare Media
TT=Trane技术
TTC=托罗配件
TTI=脂鲤技术
TTM=塔塔汽车
TTO=Tiga Acquisition
TTRE=Tiga Acquisition
TTT=20年以上债券三倍做空
TU=泰勒斯
TUFN=Tufin软件科技
TUP=特百惠
TV=墨西哥电视
TWI=泰坦国际
TWIC=Twist Investment
TWLO=Twilio
TWM=罗素2000两倍做空ETF
TWND=Tailwind
TWNI=Tailwind
TWO=双港投资
TWOpA=双港投资优先A
TWOpB=双港投资优先B
TWOpC=双港投资优先C
TWOpD=双港投资优先D
TWOpE=双港投资优先E
TWTR=推特
TX=特尔尼翁钢铁
TXT=德事隆
TYD=7-10年债券三倍做多
TYG=Tortoise能源基础设施
TYL=泰勒科技
TYO=7-10年债券三倍做空
TZA=罗素2000三倍做空ETF
U=Unity
UA=安德玛C
UAA=安德玛
UAN=CVR合伙人
UBA=优士达不动产A
UBER=优步
UBOT=机器人与人工智能专题
UBP=优士达不动产
UBPpH=优士达不动产G类优先
UBR=巴西25/50两倍做多
UBS=瑞银
UBT=20年以上债券两倍做多
UCC=消费者服务两倍做多
UCIB=CMCI总回报指数ETF
UCO=WTI原油指数两倍做多
UCON=TCW无约束加债券ETF
UDN=美元短期货币投资组合
UDOW=道琼斯指数三倍做多
UDR=UDR不动产信托
UE=Urban Edge
UEVM=选择价值动量混合指数
UFI=仪化宇辉
UFO=S网络空间指数
UFS=唐塔
UGA=即月无铅汽油ETF
UGE=美国消费品两倍做多
UGI=UGI公用事业
UGL=黄金分类指数两倍做多
UGP=Ultrapar控股
UHS=环球保健
UHT=环球医疗信托
UI=厄比奎蒂
UIS=优利系统
UITB=USAA核心中期债券ETF
UIVM=精选价值动量混合指数
UJB=美元流动指数两倍做多
UL=联合利华
ULE=美元欧元汇率两倍做多
ULST=SSgA超短期债券ETF
ULTR=彭博巴克莱短期国债
ULVM=选择价值动量混合指数
UMC=联电
UMDD=标普400中盘三倍做多
UMH=UMH地产
UMHpD=UMH地产D类优先
UN-2=联合利华
UNF=第一联合
UNFI=联合原生态食品
UNG=即月天然气ETF
UNH=联合健康
UNL=美国12个月天然气
UNM=尤纳姆
UNP=联合太平洋
UNVR=Univar Solutions
UPRO=标普500指数三倍做多
UPS=联合包裹
UPV=欧洲全市值两倍做多
UPW=美国公用事业两倍做多
URA=全球铀与核成分
URE=美国房地产两倍做多
URI=联合租赁
URNM=全球铀矿开采指数ETF
URTH=MSCI世界指数ETF
URTY=罗素2000指数做多ETF
USAC=USA Compression
USAI=美国能源独立指数ETF
USB=美国合众银行
USBpH=美国合众银行存优B
USBpM=美国合众银行存优F
USBpP=美国合众银行优先P
USCI=动态商品指数总回报
USD=美国半导体两倍做多
USDP=Usd Partners
USDU=彭博美元基金
USFD=美国食品控股
USFR=美国国债浮动利率债券
USHG=动态对冲美国股票ETF
USI=主要超短活跃收入ETF
USL=12个月轻质原油ETF
USM=美国无线电话
USML=最低波动率2倍做多
USMV=美国最低波动率指数
USNA=优莎娜
USO=前月轻质低硫原油ETF
USPH=美国理疗保健
USRT=房地产投资信托基金
USSG=美国ESG领导者指数
UST=7-10年债券两倍做多
USTB=USAA核心短期债券ETF
USVM=选择价值动量混合指数
USX=美国xpress企业
UTC=Uranium Trading
UTES=Reaves公用事业ETF
UTI=环球技术学院
UTL=Unitil
UTRN=美国大盘短期反转指数
UTSL=标普实用程序部门选择
UTZ=Utz Brands
UUP=DB美元做多ETF
UVE=万全保险
UVV=环球烟草
UWM=罗素2000两倍做多ETF
UWMC=UWM Holdings
UXI=美国工业指数两倍做多
UYG=美国金融指数两倍做多
UYM=基本材料指数两倍做多
V=Visa
VABS=Newfleet ABS/MBS ETF
VAC=万豪度假环球
VALE=淡水河谷
VALQ=美国质量价值指数ETF
VALT=ETFMG Sit超短ETF
VAMO=威尔士价值和动量ETF
VAPO=Vapotherm
VAR=瓦里安医疗
VAW=美国投资市场物料ETF
VB=CRSP美国小盘股指数
VBK=CRSP美国小盘股成长
VBR=CRSP美国小盘股价值
VCAR=RoboCar颠覆与技术ETF
VCIF=Vertical资本收入
VCLO=云与网络安全破坏ETF
VCR=投资市场非必需消费品
VCRA=Vocera通信
VDC=投资市场必需消费品
VDE=投资市场能源指数ETF
VEA=发展全市值指数净TR
VEC=Vectrus
VEDL=Vedanta
VEEV=Veeva Systems
VEGA=Star Global买卖ETF
VEGI=选择性农业生产者IMI
VEGN=美国素食气候指数ETF
VEL=Velocity Financial
VER=Vereit
VERpF=VEREIT F类优先
VET=朱砂能源公司
VEU=全世界除美国净TR美国
VFC=威富
VFH=投资市场金融指数ETF
VFIN=伏特金融科技中断ETF
VGAC=Vg Acquisition
VGK=新华富时发展欧洲市值
VGR=Vector烟草集团
VGT=美国投资市场信息技术
VHAQ=Viveon Health
VHC=Virnetx控股
VHI=瓦利化工
VHT=投资市场保健指数ETF
VIAO=VIA optronics
VICE=AdvisorShares Vice
VICI=VICI Properties
VIG=纳斯达克高股利选择性
VIOG=标普小盘股增长指数
VIOO=标普600小盘股指数ETF
VIOV=标普600小盘股价值
VIPS=唯品会
VIS=美国投资市场工业指数
VIST=Vista Oil & Gas
VIV=保罗迪圣电讯
VLO=瓦莱罗能源
VLRS=Volaris航空控股
VLU=标普1500低估值倾斜
VLUE=美国增强价值指数ETF
VMC=火神材料
VMI=维蒙特工业
VMW=威睿
VNCE=文斯控股
VNE=Veoneer
VNLA=短期收益ETF
VNM=MVIS越南指数ETF
VNMC=沃恩・纳尔逊中盘股
VNO=沃纳多房地产基金
VNOpK=沃纳多房地产优先K
VNOpL=沃纳多房地产优先L
VNOpM=沃纳多房地产优先M
VNQ=房地产25/50指数ETF
VNSE=沃恩・纳尔逊精选ETF
VNT=Vontier
VNTR=Venator Materials
VO=美国中盘股指数ETF
VOE=美国中盘股价值指数
VOO=标普500ETF
VOOG=标普500增长指数
VOOV=标普500价值指数ETF
VOT=CRSP美国中等增长ETF
VOX=美国电信服务指数ETF
VOYA=Voya Financial
VOYApB=Voya Financial优先B
VPC=Indxx私人信贷指数
VPCC=VPC Impact
VPG=Vishay精密集团
VPL=新华富时发展亚太区
VPOP=伏特流行文化颠覆ETF
VPU=美国公用事业25/50
VRAI=Indxx实物资产收益
VRP=可变利率投资组合ETF
VRS=Verso
VRT=Vertiv
VRT-1=Vertiv
VRTV=Veritiv
VSH=威世科技
VSL=大盘股指数ETF
VSS=全球小盘股指数净税
VST=Vistra
VSTO=Vista Outdoor
VT=新华富时全球全市值
VTEB=全国AMT免税市政债券
VTI=CRSP美国总市场指数
VTOL=Bristow Group
VTR=芬塔
VTV=CRSP美国大盘股价值
VUG=美国大盘成长指数ETF
VV=美国大盘股指数ETF
VVI=Viad
VVNT=Vivint Smart Home
VVV=胜牌
VWO=新华富时新兴市场ETF
VXF=标普完成指数ETF
VYGG=Vy Global
VYM=高股息率指数净TR美国
VZ=威瑞森通信
VZIO=VIZIO Holding
W=Wayfair
WAB=美国西屋制动
WAL=阿莱恩斯西部银行
WANT=非必需消费品选择行业
WARR=Warrior
WARR.U=Warrior
WAT=沃特世
WBAI=500彩票网
WBIE=上升收益3000 ETF
WBIF=BullBear价值3000 ETF
WBIG=BullBear收益3000 ETF
WBII=BullBear全球收益ETF
WBIL=BullBear质量3000 ETF
WBIN=趋势开关总收益ETF
WBIT=趋势开关总回报ETF
WBIY=功率高红利指数ETF
WBK=澳洲西太平洋银行
WBS=韦伯斯特金融
WBSpF=韦伯斯特金融F类优先
WBT=Welbilt
WCC=西科国际
WCN=Waste Connections
WD=Walker & Dunlop
WDIV=标普全球股息贵族指数
WDR=瓦德尔-里德金融
WEAT=小麦基金基准ETF
WEBL=互联网指数3倍做多ETF
WEBS=互联网指数3倍做空ETF
WEC=WEC能源集团
WECpY=WEC能源集团优先Y
WEI=微贷网
WELL=Welltower
WES=Western Midstream
WEX=WEX
WF=韩国友利金融
WFC=富国银行
WFCpL=富国银行L类优先
WFCpN=富国银行N类优先
WFCpO=富国银行O类存托优先
WFCpP=富国银行P类存托优先
WFCpQ=富国银行Q类存托优先
WFCpX=富国银行X类存托优先
WFCpY=富国银行Y类优先
WFG=West Fraser Timber
WFH=主动远程工作指数ETF
WGLD=增强型黄金信托ETF
WGO=温尼巴格实业
WH=温德姆酒店及度假村
WHD=Cactus
WHG=韦斯特德控股
WHR=惠而浦
WIL=巴克莱女性领导ETN
WIP=国际通货膨胀挂钩证券
WIT=Wipro
WIZ=MAI斗牛者斗士指数ETF
WK=Workiva
WLK=Westlake化学
WLKP=Westlake Chemical
WLL=怀丁石油
WM=美国废物管理
WMB=威廉姆斯
WMC=西方资产抵押贷款投资
WMK=韦斯市场
WMS=Advanced Drainage
WMT=沃尔玛
WNC=WABASH国立
WNS=WNS控股
WOMN=晨星妇女赋权指数ETF
WOR=沃辛顿工业
WORK=Slack Technologies
WOW=WideOpenWest
WPC=W.P.Carey
WPCA=Warburg Pincus
WPCB=Warburg Pincus
WPF=Foley Trasimene
WPG=Washington优先G
WPGpH=Washington优先H
WPGpI=Washington优先I
WPM=Wheaton Precious
WPP=WPP
WPS=标普开发非美房地产
WRB=WR柏克利
WRE=WRE基金
WRI=魏因加滕房地产投资
WRK=WestRock
WSM=威廉索诺玛
WSO=华斯科
WSO.B=华斯科B类普通
WSR=Whitestone房地产
WST=西医服务
WTI=W&T海底钻探
WTM=白山保险集团
WTMF=管理期货策略基金ETF
WTRG=Essential
WTS=沃茨水工业
WTTR=Select Energy
WU=西联汇款
WWE=世界摔角娱乐
WWJD=激发全球希望指数ETF
WWOW=世界无浪费ETF
WWW=沃尔弗林集团
WY=惠好
X=美国钢铁
XAR=标普航天与国防行业
XBI=标普生物技术选择行业
XBUY=EQM国际电子商务指数
XCEM=Beta主题新兴市场
XDIV=2027系列美国股票指数
XEC=Cimarex能源
XES=石油天然气设备和服务
XFLT=XAI Octagon信托
XHB=房产选择行业指数ETF
XHE=标普医疗保健设备选择
XHR=森雅酒店及度假村
XHS=标普保健服务选择行业
XIN=鑫苑置业
XITK=FactSet创新技术指数
XL=XL Fleet
XLB=标普材料行业指数ETF
XLC=通信服务选择行业指数
XLE=标普能源行业指数ETF
XLF=财经精选行业指数ETF
XLG=标普500 50强指数ETF
XLI=标普工业指数ETF
XLK=标普高科技指数板块
XLP=标普消费者指数ETF
XLRE=房地产行业指数ETF
XLSR=SSGA美国部门轮值ETF
XLU=标普实用程序部门选择
XLV=标普医疗保健指数ETF
XLY=非必需消费品选择行业
XME=金属和矿业选择行业
XMHQ=标普中盘质量指数ETF
XMLP=Exmar Energy
XMLV=标普中盘400低波动率
XMMO=中型股动量指数ETF
XMPT=城市债券封闭式基金
XMVM=中型股高动能指数ETF
XNTK=纽交所技术指数ETF
XOM=埃克森美孚
XOP=石油天然气勘探开发
XOUT=美国大型股指数ETF
XPEV=小鹏汽车
XPH=标普制药行业指数ETF
XPO=XPO物流
XPOA=Dpcm Capital
XPP=中国50-美元两倍做多
XRLV=标普500响应指数ETF
XRT=标普零售行业指数ETF
XRX=施乐
XSD=标普半导体选择行业
XSLV=标普小盘600低波动率
XSMO=小型股600动量指数ETF
XSOE=新兴市场国有除外企业
XSVM=高动能价值指数ETF
XSW=标普软件与服务选择
XTF=Exeter Finance
XTL=标普电信选择ETF
XTN=运输选择行业指数ETF
XVZ=标普动态期货总回报
XWEB=互联网行业指数ETF
XYF=小赢科技
XYL=赛莱默
XYLD=标普500买入指数ETF
XYLG=标普500BuyWriteETF
Y=Alleghany保险
YAC=Yucaipa Acquisition
YALA=Yalla Group
YANG=富时中国指数三倍做空
YCL=美元/日元两倍做多
YCS=美元日元汇率两倍做多
YELP=Yelp
YETI=YETI控股
YEXT=Yext
YINN=富时中国3倍做多ETF
YLD=Edge活跃收益ETF
YOLO=顾问共享纯大麻ETF
YPF=阿根廷YPF
YRD=宜人金科
YSG=逸仙电商
YUM=百胜餐饮
YUMC=百胜中国
YXI=中国50指数做空
YXR=永雄资产管理
YYY=ISE高收入指数ETF
ZBH=齐默巴奥米特控股
ZCAN=加拿大因素混合A系列
ZDEU=德国因素混合A系列
ZEN=Zendesk
ZEPP=华米科技
ZGBR=英国因子组合A系列
ZHOK=香港大中型美元指数
ZIG=收购者指数ETF
ZIM=ZIM Integrated
ZJPN=日本因素混合A系列
ZNH=南方航空
ZROZ=长期国库券主要STRIPS
ZSL=白银分类指数两倍做空
ZTO=中通快递
ZTR=Virtus全球股息及收入
ZTS=硕腾
ZUO=祖睿
ZYME=Zymeworks
[name_168_170]
ConfigVer=20210303_2685414365
AAMC=Altisource资产管理
AAU=Almaden矿业
ACU=Acme联合
ACY=Aerocentury
ADRA=Adara Acquisition
AE=亚当斯资源与能源
AGE=AgeX Therapeutics
AIM=AIM ImmunoTech
AINC=Ashford
AIRI=航空工业集团
AMBO=安博教育
AMPE=安皮奥制药
AMS=美国共享医院服务
ANVS=Annovis Bio
APT=阿尔法科技
ARMP=Armata医药
ASM=Avino银及金矿
ATNM=Actinium
AUMN=黄金矿产
AWX=Avalon控股
AXU=Alexco资源
BATL=Battalion Oil
BDL=Flanigan's企业
BDR=Blonder Tongue实验室
BGI=Birks Group
BHB=Bar Harbor
BIOX=Bioceres Crop
BKTI=BK科技
BMTX=BM Technologies
BNCH=Benechill
BRG=Bluerock Residential
BRGPRA=Bluerock 优先A
BRGpC=Bluerock 优先
BRGpD=Bluerock 优先D
BRN=Barnwell工业
BTG=B2gold
BTN=Ballantyne Strong
BWL.A=Bowl America
CANF=灿菲特生物制药
CCF=Chase
CDOR=Condor Hospitality
CEI=Camber能源
CHFW=Consonance-hfw
CIX=CompX国际
CKX=CKX Lands
CMCL=Caledonia Mining
CMT=Core Molding科技
COHN=Cohen & Company
CPHI=惠普森医药
CQP=Cheniere能源合作伙伴
CRHM=Crh Medical
CTEK=Cynergistek
CVM=CEL-SCI
CVR=芝加哥机械
CVU=CPI航空
DIT=AMCON Distributing
DLA=Delta服饰
DNN=丹尼森矿业
DPW=Ault Global Holdings
DSS=Document安全系统
DXF=敦信金融
DXR=Daxor
ECF=Ellsworth Growth
ELA=Envela
ELLO=Ellomay Capital
ELMD=Electromed
EMAN=eMagin
EMX=EMX Royalty
ENSV=Enservco
EPM=Evolution Petroleum
EQX=Equinox Gold
ESP=Espey
EVBN=埃文斯万通金控
EVI=EVI Industries
EXN=Excellon Resources
FCHS=First Healthcare
FRD=Friedman工业
FSI=Flexible Solutions
FSP=Franklin Street
FTSI=FTS国际
FURY=Fury Gold
GAU=Galiano Gold
GBR=新概念能源
GDP=古德里奇
GLDG=Goldmining
GLQ=Clough Global Equity
GLV=Clough全球股息和收益
GOED=1847 Goedeker
GORO=黄金资源
GPL=Great Panther Mining
GROY=Gold Royalty
GSAT=全球星
GSS=Golden Star资源
GSV=Gold Standard
GTE=Gran Tierra能源
HMG=HMG/Courtland
HUSA=休斯敦能源
HWMp=Howmet优先
HYLT=HYLETE
IBIO=iBio
ID=PARTS iD
IDW=IDW Media Holdings
IGC=India全球化资本
IHT=Ih信托
IMH=Impac抵押控股
IMO=帝国石油
INDO=Indonesia能源
INFU=Infusystem
INS=Intelligent系统
INTT=Intest
INUV=Inuvo
IOR=Income Opportunity
ISDR=Issuer Direct
ISR=Isoray
ITP=东方纸业
ITRG=Integra Resources
JOB=GEE Group
KIQ=凯尔索科技
KLR=Kaleyra
LCTX=Lineage Cell
LEU=Centrus Energy
LGL=The LGL Group
LNG=Cheniere能源
LODE=Comstock Mining
LOV=Spark Networks
LSF=Laird Superfood
M00588=阿姆柯金属优先
M01033=Worlds
M01269=Neuberger Berman
MAG=MAG银矿
MCF=Contango油气
MHH=Mastech Digital
MITQ=Moving iMage技术
MLSS=里程碑科技
MMX=Maverix Metals
MSN=Emerson Radio
MTA=Metalla Royalty
MTNB=Matinas Biopharma
MXC=Mexco Energy
MYO=Myomo
NAK=北方王朝矿业
NAVB=Navidea生物制药
NBA=New Beginnings
NBY=Novabay制药
NEN=新英格兰地产顾问
NES=Nuverra环境解决方案
NFP=Nanoflex Power
NG=NOVAGOLD资源
NGD=新黄金
NHC=National医疗
NNVC=NanoViricides
NOG=Northern石油天然气
NSPR=InspireMD
NTIP=网络技术
NTN=NTN Buzztime
NXE=Nexgen能源
OCX=Oncocyte
OGEN=Oragenics
ORLA=Orla Mining
PCGpA=太平洋煤气电力优先A
PCGpB=太平洋煤气电力优先B
PCGpC=太平洋煤气电力优先C
PCGpD=太平洋煤气电力优先D
PCGpE=太平洋煤气电力优先E
PCGpG=太平洋煤气电力优先G
PCGpH=太平洋煤气电力优先H
PCGpI=太平洋煤气电力优先I
PED=PEDEVCO
PENA=半岛能源
PHGE=BiomX
PLAG=美国绿星球
PLG=铂族金属
PLM=Polymet矿业
PLX=PROTALIX生物疗法
PLYMpA=Plymouth 优先A
PRHR=PetroShare
PRK=Park National
PTK=PTK Acquisition
PTN=PALATIN技术
PW=Power房地产投资信托
PWpA=Power房地产优先A
PZG=派拉蒙黄金内华达
REI=环能源
REPX=Riley Exploration
RHE=Regional Health
RHEpA=Regional Health优先A
RLGT=Radiant物流
RMED=Ra Medical Systems
RVP=Retractable技术
SACH=Sachem Capital
SDPI=高级钻井产品
SEB=Seaboard
SENS=Senseonics控股
SIF=Sifco工业
SILV=SilverCrest Metals
SIM=Group Simec
SMTS=Sierra Metals
SNMP=Sanchez Midstream
SSY=SunLink卫生系统
STXS=趋实医疗设备
SVM=希尔威
SVT=Servotronics
SYN=Synthetic Biologics
TGB=Taseko矿业
THM=国际塔山
TKAT=香港大公文交所
TMBR=Timber
TMP=汤普金斯金融
TMQ=Trilogy Metals
TPHS=三一广场控股
TRT=Trio-Tech国际
TRX=坦桑尼亚黄金
TRXC=Asensus Surgical
UAMY=美国锑
UAVS=AgEagle天线系统
UEC=Uranium Energy
UFAB=Unique Fabricating
URG=Ur-能源
USAS=Americas Gold
UUU=通用安全仪器
UUUU=Energy Fuels
VGZ=Vista黄金
VNRX=Volitionrx
VOLT=伏特资讯科学
WLMS=Williams Industrial
WRN=西方铜金
WTT=Wireless电信
WYY=Widepoint
XPL=Solitario Zinc
XTNT=Xtant医控股
XXII=22nd Century
YCBD=cbdMD
ZDGE=Zedge
ZOM=Zomedica
[name_168_171]
ConfigVer=20210303_2296278471
ACES=阿特拉斯清洁能源
ACIO=Aptus领取收入机会ETF
ACSI=客户满意度可投资指数
ADFI=动态固定收益ETF
ADME=缩编管理型股票ETF
AESR=美国股票行业轮换ETF
AFIF=安菲尔德全球固定收益
AGT=阿根廷25/50指数ETF
ALTS=晨星多元化替代指数
AMER=Emles美国制造ETF
ARCM=储备资本管理ETF
AUGZ=结构化结果ETF-8月
AVDG=美国大盘ESG指数ETF
AVDR=美国大型股领先ETF
BAPR=标普500 Buffer 四月
BAUG=标普500缓冲ETF-8月
BBAX=目标市场曝光指数ETF
BBCA=目标市场曝光指数ETF
BBEU=欧洲目标市场暴露指数
BBIN=目标市场暴露指数ETF
BBJP=日本目标市场暴露指数
BBRE=REIT25-50定制指数ETF
BBSA=短期美国综合债券指数
BBUS=目标市场暴露指数ETF
BDEC=标普500缓冲ETF-12月
BFEB=标普500缓冲ETF-2月
BGLD=黄金策略季度缓冲ETF
BJAN=创新者标普500缓冲1月
BJUL=标准普尔500缓冲区ETF
BJUN=标普500缓冲ETF-6月
BLDG=坎布里亚全球房地产
BMAR=标普500缓冲ETF-3月
BMAY=标普500缓冲ETF-5月
BNOV=标普500缓冲ETF-11月
BOB=最佳核心动力ETF
BOCT=标普500缓冲区ETF10月
BOSS=美国创始人公司ETF
BSEP=标普500缓冲ETF-9月
BUFD=深度缓冲ETF基金
BUFF=功率缓冲策略指数ETF
BUFR=缓冲型ETF投资基金ETF
BUYZ=颠覆性商业ETF
CALF=美国小额现金牛100
CBOE=芝加哥期权交易所
CBTG=Cabot成长ETF
CEFS=萨巴封闭式基金ETF
CEMB=晨星新兴市场公司债券
CFCV=焦点价值ETF
CNYA=MSCI中国A国际指数
COWZ=美国现金牛100指数
CSM=瑞士信贷130/30大盘股
DALT=资本多元化选择ETF
DAUG=美股深度缓冲ETF-8月
DBJA=双重堆叠9缓冲ETF1月
DBOC=双重堆叠9缓冲ETF10月
DDEC=美股深度缓冲ETF-12月
DDLS=动态货币对冲国际小盘
DDWM=动态货币对冲国际股票
DECZ=结构化结果ETF-12月
DEFA=欧澳远东对美元对冲
DEFN=Emles保护性分配ETF
DFEB=美股深度缓冲ETF-2月
DFHY=战术高收益指数ETF
DFND=DIVCON股息维持者指数
DFNV=Forlines风险管理创新
DIVB=晨星美国股息增长指数
DIVO=扩大CWP增强股息收益
DJAN=美股深度缓冲ETF-1月
DJUL=美股深度缓冲ETF-7月
DJUN=美股深度缓冲ETF-6月
DMAY=美股深度缓冲ETF-5月
DNOV=美股深度缓冲ETF-11月
DOCT=美国股票深度缓冲ETF
DRSK=Aptus定义风险ETF
DSEP=美股深度缓冲ETF-9月
DSJA=创新者双重堆叠ETF1月
DSOC=创新者双重堆叠ETF
DTEC=Indxx颠覆性技术指数
DUDE=SectorSurfer动量ETF
EAOA=意识积极分配指数ETF
EAOK=意识保守分配指数ETF
EAOM=意识中等分配指数ETF
EAOR=意识增长分配指数ETF
EBLU=全球水质ESG指数ETF
EDEN=丹麦IMI 25/50指数
EFNL=芬兰IMI 25/50指数ETF
EGIS=2ndVote社会保卫ETF
EMDV=新兴市场股息指数ETF
EMGF=新兴市场多因素指数
EMHY=高收益债券指数ETF
EMSH=短期新兴市场债券ETF
EMTL=双线新兴市场固定收益
ENOR=挪威指数IMI25/50ETF
EPRF=标普美国优先股指数
ESCR=可持续发展指数ETF
ESEB=多元化主权指数ETF
ESGV=美国所有上限选择
ESHY=高收益美元指数ETF
ESML=美国小盘扩展关注指数
EUCG=欧几里德资本增长ETF
EURZ=南欧美元对冲指数ETF
EWGS=MSCI德国小盘指数ETF
EWUS=MSCI英国小盘股指数
EYLD=新兴股东收益ETF
FAUG=美国股票缓冲ETF-8月
FBCG=罗素1000增长指数ETF
FBCV=富达蓝筹价值ETF
FCPI=通货膨胀指数股票ETF
FCTR=资本大盘因子轮换指数
FDEC=美国股票缓冲ETF-12月
FDEM=富达新兴市场多因素
FDEV=富达目标国际因素指数
FDG=聚焦动态增长ETF
FEBZ=结构化结果ETF-2月
FEDX=Emles联邦承包商ETF
FFEB=美国股票缓冲ETF-2月
FFHG=对冲增长ETF
FFSG=智能成长型ETF
FFTG=战术成长型ETF
FFTI=战术收入ETF
FGRO=富达增长机会ETF
FIBR=固定收益均衡风险指数
FJAN=美国股票缓冲ETF-1月
FJUL=美国股票缓冲ETF-7月
FJUN=美国股票缓冲ETF-6月
FLBL=自由高级贷款ETF
FLDR=低期投资等级因素指数
FLHY=自由高收益公司ETF
FLIA=自由国际综合债券ETF
FLQL=美国大盘股指数ETF
FLQM=美国中盘股指数ETF
FLQS=美国小盘股指数ETF
FLV=聚焦大型价值ETF
FMAG=富达麦哲伦ETF
FMAY=美国股票缓冲ETF-5月
FMIL=富达新千年ETF
FNOV=美国股票缓冲ETF-11月
FOCT=美国股票缓冲ETF-10月
FPRO=富达房地产投资ETF
FRDM=生命+自由100指数ETF
FSEP=美国股票缓冲ETF-9月
FSMO=富达中小盘机会ETF
FUT=托管期货策略ETF
GCOW=全球现金股息100
GHYG=发展市场高收益指数
GOVZ=美长期国债本金STRIPS
GSEE=新兴市场大中型股ETF
GSEW=美国大型股等权重ETF
GSID=发达市场大中型股ETF
GSST=高盛访问超短债券ETF
GSUS=美国大中型股指数ETF
GTIP=财政通胀保护美元债券
HCRB=哈特福德核心债券ETF
HEGD=对冲股票美国大盘ETF
HELX=基因组发展ETF
HSRT=哈特福德短期ETF
HYDB=高收益防守债券指数
HYHG=高收益率国债对冲ETF
HYXU=非美高收益指数ETF
IAGG=10%发行人下标指数ETF
IAUF=iShares黄金策略ETF
IBHA=2021高收益率指数ETF
IBHB=2022高收益率指数ETF
IBHC=2023高收益率指数ETF
IBHD=2024高收益率指数ETF
IBHE=2025高收益率指数ETF
IBHF=2026年定期高产和收益
IBML=市政系列2023年12月
IBMM=2024年12月市政指数
IBMN=自由市政系列2025ETF
IBMO=调整后2026指数
IBMP=2027年12月指数
IBMQ=调整后2028系列指数
ICOW=国际现金牛100指数
ICSH=iShares超短期债券ETF
ICVT=美国可转换债券ETF
IDHD=低波动性高股息指数
IECS=iShares发展美国消费
IEDI=iShares进化美国开支
IEFN=iShares发展美国金融
IEHS=iShares发展美国医疗
IEIH=iShares发展美国创新
IEME=iShares进化美国媒体
IETC=iShares进化美国科技
IFRA=美国基础设施指数ETF
IGEB=投资级债券增强指数
IGHG=企业投资等级指数ETF
IGLD=黄金策略目标收益ETF
IGRO=晨星非美股息增长指数
IMFL=国际开发动态多因素
IMOM=建筑师国际定量动量
INDA=印度总回报指数ETF
IQDG=国际质量红利增长
IQM=富兰克林智能机器ETF
IVAL=国际定量价值指数ETF
IVDG=景顺聚焦发现增长ETF
IVLC=美国大盘核心ESG ETF
IVRA=景顺房地产ESG ETF
IVSG=景顺精选增长ETF
IYLD=晨星多资产高收入
IZRL=ARK以色列创新指数ETF
JANZ=结构化结果ETF-1月
JCPB=摩根大通核心加债券
JMST=超短期市政收入ETF
JMUB=摩根大通市政ETF
JPHY=高收益研究增强型ETF
JPIB=全球债券机会ETF
JPST=美国国库券指数ETF
JULZ=结构化结果ETF-7月
KALL=MSCI中国全股指数
KAPR=功率缓冲ETF-4月
KJAN=罗素功率缓冲ETF-1月
KJUL=罗素功率缓冲ETF-7月
KNG=股息贵族目标收入指数
KNGS=UPHOLDINGS复合国王
KOCT=罗素功率缓冲ETF-10月
KWT=精选规模流动性上限
LEAD=领导者股息指数ETF
LIV=Emles \@ Home ETF
LQDI=通货膨胀对冲公司债券
LSLT=truBeta美国市场指数
LUXE=Emles奢侈品ETF
LVHI=国际低波动高股息对冲
LYFE=Life Neutral Plus
MAAX=Vectors市政分配ETF
MAGA=GOP股票追踪指数
MARZ=结构化结果(3月)ETF
MBBB=美BBB公司债券指数ETF
MBND=Nuveen市政债券ETF
MEAR=贝莱德短期市政债券
MFMS=MFAM小盘股成长ETF
MIG=矢量穆迪分析公司债券
MRGR=标普合并套利指数ETF
MRSK=敏捷股票管理风险ETF
MSTB=市场状态战术贝塔ETF
MSVX=阿尔法探索者ETF
NAPR=功率缓冲ETF-4月
NEAR=贝莱德短期到期债券
NJAN=功率缓冲ETF-1月
NJUL=功率缓冲ETF-7月
NOCT=功率缓冲ETF-10月
NUDM=国际发展市场股权指数
NUEM=ESG新兴市场股权ETF
NULC=ESG美国大型股指数ETF
NULG=美国大盘成长指数ETF
NULV=美国大盘价值指数ETF
NUMG=美国中盘成长指数ETF
NUMV=美国中盘价值指数ETF
NURE=短期房地产投资信托
NUSC=ESG美国小盘指数ETF
OCTZ=结构化结果ETF-10月
OILK=K-1免费原油策略ETF
OMFL=动态多因素指数ETF
OMFS=OFI动态多因素指数ETF
PAPR=标普功率缓冲ETF-4月
PAUG=标普功率缓冲ETF-8月
PAVE=美国基础设施发展指数
PAWZ=FactSet宠物护理指数
PBDM=前北美指数净TR美国
PBEE=新华富时新兴指数ETF
PBND=美国广泛市场指数
PBSM=MSCI美国小型股指数
PBTP=美国通胀挂钩国库指数
PBUS=MSCI美国指数
PDEC=标普功率缓冲ETF-12月
PEX=直接上市私募股权指数
PFEB=标普功率缓冲ETF-2月
PFFD=美林核心优先证券指数
PJAN=创新标普500功率缓冲
PJUL=标普功率缓冲ETF-7月
PJUN=标普功率缓冲ETF-6月
PMAR=标普功率缓冲ETF-3月
PMAY=标普功率缓冲ETF-5月
PNOV=标普功率缓冲ETF-11月
POCT=动力缓冲区ETF-10月
PREF=频谱优先证券活动ETF
PRNT=总3D打印指数ETF
PSCX=Swan SOS保守12月ETF
PSEP=标普功率缓冲ETF-9月
PSFD=Swan SOS Flex12月ETF
PSFF=步行者天鹅SOS基金ETF
PSMB=平衡多资产配置组合
PSMC=保守多资产配置组合
PSMD=Swan SOS中度12月ETF
PSMG=增长多资产配置组合
PSMM=中度保守多资产分配
PTEU=Trendpilot欧洲指数
PTLC=美国大市值Trendpilot
PTMC=中盘股Trendpilot
PTNQ=NASDAQ100指数ETF
PWS=Pacer财富保护指数ETF
QCON=质量可转换证券ETF
QDEC=增长100缓冲ETF-12月
QDIV=标普500质量高股息
QMOM=建筑师定量动量指数
QPFF=美国世纪质量优先ETF
QVAL=建筑师定量价值ETF
RDFI=动态固定收益ETF
REC=Emles房地产信贷ETF
REGL=中盘股息贵族指数ETF
RESD=国际ESG基金ETF
RESE=新兴市场ESG基金ETF
RODE=多元国际指数ETF
ROMO=解决股票动量指数ETF
RTAI=税收优惠收入ETF
RVRS=反向上限加权美国大盘
RYLD=罗素2000BuyWriteETF
SECT=主要板块轮动ETF
SEPZ=结构化结果ETF-9月
SFHY=短期高收益企业债券
SFIG=短期公司债券基本面
SHAG=美国短期总体债券ETF
SLT=高曝光指数ETF
SMDV=罗素2000股利增长ETF
SMIN=印度小盘股指数ETF
SMMD=罗素2500指数ETF
SMMV=美国小盘股最低波动
SPMV=标普500最低波动指数
STLC=大型股指数混合风ETF
STLG=成长因素指数ETF
STLV=因素价值风格指数ETF
STMB=中型股指数混合风ETF
STOT=双线短期总回报战术
STSB=全球人工智能指数ETF
SULR=可持续能源II ETF
SVAL=美国小盘价值因子ETF
SVXY=短期期货指数.5倍做空
TAEQ=趋势聚集美国ETF
TAIL=尾部风险ETF
TBJL=20年国债9缓冲ETF-7月
TCTL=资本前沿优势多元战术
TDV=技术股息贵族指数ETF
TEGS=趋势汇总ESG ETF
TFIV=目标收益5%加指数
TFJL=20年国债5级ETF-7月
TFLT=10年国债+2%加息指数
THY=敏捷股动态战术收益
TMAT=MSCI ACWI指数ETF
TMDV=罗素股利精英指数ETF
TMFC=Motley Fool100指数
TOKE=Cambria大麻ETF
TPAY=全球数字支付基础设施
TRTY=三位一体ETF
TSJA=创新者三重堆叠ETF1月
TSOC=创新三重堆叠ETF-十月
TTAC=美国自由现金流质量
TTAI=国际自由现金流质量
UAPR=标普500 Buffer 四月
UAUG=标普500超缓冲ETF-8月
UDEC=标普500超缓冲ETF12月
UFEB=标普500超缓冲ETF-2月
UJAN=创新者标普500超缓冲
UJUL=标普500超缓冲ETF-7月
UJUN=标普500超缓冲ETF-6月
UMAR=标普500超缓冲ETF-3月
UMAY=标普500超缓冲ETF-5月
UNOV=标普500超缓冲ETF11月
UOCT=标普500超缓冲ETF十月
USEP=标普500超缓冲ETF-9月
USEQ=增强值等权指数ETF
USHY=美国高收益约束ETF
USMF=智慧多因素指数基金
UVXY=恐慌指数1.5倍做多
VCEB=美国公司SRI选择ETF
VFLQ=美国流动性因素ETF
VFMF=美国多因素ETF
VFMO=美国动量因素ETF
VFMV=美国最小波动率ETF
VFQY=美国品质因素ETF
VFVA=美国价值因素ETF
VIRS=策略指数ETF
VIXM=中期波动期货指数ETF
VIXY=短期期货恐慌指数ETF
VMOT=价值动向趋势ETF
VSGX=全球全额上限选择指数
VWID=WMC国际股息ETF
VXX=短期期货恐慌指数ETF
VXZ=中期波动期货指数ETF
WFHY=高收益企业债券基本面
WFIG=美国本土公司债券
WLDR=亲和世界领袖指数ETF
WUGI=NextG经济ETF
XDAT=富兰克林指数数据ETF
XJH=标普中盘可持续性筛选
XJR=小盘600可持续性筛选
XSHD=小型600低波动高股息
XSHQ=标普SmallCap质量指标
XVV=标普500可持续发展ETF
YDEC=国际股票缓冲ETF-12月
[name_168_172]
ConfigVer=20210303_0
[name_168_173]
ConfigVer=20210303_0
[name_168_174]
ConfigVer=20210303_0
